#domain
hospital
#levelname
MAPF00
#colors
blue: 0,1,2,3
green: A
#initial
+++++++++++++
+0123       +
+A       ++++
+           +
+        ++ +
+         + +
+++++++++++++
#goal
+++++++++++++
+           +
+        ++++
+           +
+        ++ +
+123      +0+
+++++++++++++
#end
