#domain
hospital
#levelname
N12
#colors
blue: 0,1,2
#initial
++++++++++
+012     +
+  +++++++
+        +
+        +
+++++++  +
+        +
+        +
+        +
++++++++++
#goal
++++++++++
+        +
+  +++++++
+        +
+        +
+++++++  +
+        +
+        +
+   012  +
++++++++++
#end
