#domain
hospital
#levelname
46
#colors
red: 0, A, C
#initial
++++++++++++
+        0 +
+  + +++++++
+  +       +
+  +       +
+AC+++++++ +
+  +       +
++++++++++++
#goal
++++++++++++
+          +
+  + +++++++
+  +       +
+  +       +
+  +++++++ +
+  +AC0    +
++++++++++++
#end
