#domain
hospital
#levelname
46
#colors
red: 0, A, C
#initial
++++++++++++
+        0 +
+  + +++++++
+  +       +
+  +       +
+A +++++++ +
+  +       +
++++++++++++
#goal
++++++++++++
+          +
+  + +++++++
+  +       +
+  +       +
+  +++++++ +
+  +0A     +
++++++++++++
#end
