#domain
hospital
#levelname
A2
#colors
blue: 0, A
#initial
+++++++++++++++
+0            +
+AAAAAAAAAA   +
+AAAAAAAAAA   +
+++++++++++++++
#goal
+++++++++++++++
+             +
+            A+
+            A+
+++++++++++++++
#end
