#domain
hospital
#levelname
A2
#colors
blue: 0, A
red: 1, B
#initial
+++++++++++++++
+ 0           +
+AAAAAAAAAA   +
+AAAAAAAAAA   +
+BBBBBBBBBB   +
+BBBBBBBBBB   +
+ 1           +
+++++++++++++++
#goal
+++++++++++++++
+0           A+
+            A+
+            A+
+            B+
+            B+
+1           B+
+++++++++++++++
#end
