#domain
hospital
#levelname
A2
#colors
blue: 0, A
red: 1
#initial
+++++++++++++++
+0            +
+AA           +
+1A           +
+++++++++++++++
#goal
+++++++++++++++
+0           1+
+            A+
+             +
+++++++++++++++
#end
