#domain
hospital
#levelname
A2
#colors
blue: 0, A
red: 1
#initial
+++++++++++++++
+0            +
+AAAAA        +
+1AAAA        +
+++++++++++++++
#goal
+++++++++++++++
+0           1+
+            A+
+             +
+++++++++++++++
#end
