#domain
hospital
#levelname
A2
#colors
blue: 0, A
#initial
+++++++++++++++
+0            +
+AAAAAAA      +
+AAAAAAA      +
+++++++++++++++
#goal
+++++++++++++++
+0           A+
+             +
+             +
+++++++++++++++
#end
