#domain
hospital
#levelname
A0
#colors
blue: 0, A
#initial
++++++++++++++++
+0             +
+A             +
+              +
+              +
+              +
+              +
++++++++++++++++
#goal
++++++++++++++++
+              +
+              +
+              +
+              +
+              +
+             A+
++++++++++++++++
#end
