#domain
hospital
#levelname
G113
#colors
blue: 0, 1, 2, 3, 4, 5, 6, A, B
#initial
+++++++++++++++++++
+       +  6      +
+++++ +++ 5 +  ++ +
+    2+   + +     +
+ +++++ ++0   +++ +
+   +   + +   +   +
+ + + +++ +++++ +++
+   +   + +   +3  +
+  +++ A+ + + +++ +
+     +4 1  +     +
+++++ +  ++  ++++ +
+   +   +   +   + +
+ + +++++ +++ + + +
+B+       +   +  A+
+++++++++++++++++++
#goal
+++++++++++++++++++
+       +         +
+++++ +++   +  ++ +
+     +   + + 0   +
+ +++++ ++    +++ +
+   +   +B+   +   +
+ + + +++ +++++A+++
+   +5  + +   +   +
+  +++  + + +3+++ +
+     +     +     +
+++++ +  ++  ++++ +
+   + 6 +   +   + +
+ + +++++ +++ + + +
+ +A      +   +   +
+++++++++++++++++++
#end
