#domain
hospital
#levelname
G115
#colors
blue: 0, 1, 2, A
#initial
+++++++++++++++
+   +     A + +
+ + + +  ++ + +
+ + + +   +   +
+ + + +++ +++ +
+ + +   +     +
+ +++++ + ++  +
+     +     + +
+++ + +++++ + +
+ A +   +0  + +
+ +++++++ A++ +
+     +   +   +
+  ++ + +++ + +
+  2+ + +   + +
+1+ + + +  ++ +
+   +   +   + +
+++++++++++++++
#goal
+++++++++++++++
+   + 2     + +
+ + + +  ++ + +
+ + + +   +   +
+ + + +++ +++ +
+ + +   +     +
+ +++++ + ++  +
+    A+     + +
+++ + +++++ + +
+   + 1 +   + +
+ +++++++  ++ +
+     +   + A +
+  ++ + +++ + +
+   + + +A  + +
+ + + + +  ++ +
+   +   +   + +
+++++++++++++++
#end
