#domain
hospital
#levelname
G119
#colors
blue: 0, E, D
#initial
+++++++++
+       +
+ + + + +
+ +D+0  +
+ +   +++
+   E   +
+++++++++
#goal
+++++++++
+   E   +
+ + + + +
+ + +   +
+ +   +++
+    0  +
+++++++++
#end
