#domain
hospital
#levelname
G121
#colors
blue: 0, A, C
#initial
+++++++++++++
+       +   +
+ +0+   +++ +
+ C   +     +
+ + + +++A+++
+ + + +     +
+   +++ +++ +
+ +   + +   +
+ +++ + +++C+
+ +   +     +
+++ +++ + + +
+   +     + +
+ +++++++++ +
+ +         +
+ + +++++++++
+           +
+++++++++++++
#goal
+++++++++++++
+      C+   +
+ + +   +++ +
+     +     +
+ + + +++ +++
+ + + +     +
+   +++ +++ +
+ +   + +   +
+ +++ + +++ +
+ +   +     +
+++ +++ + + +
+   +     + +
+ +++++++++ +
+ +         +
+ + +++++++++
+           +
+++++++++++++
#end
