#domain
hospital
#levelname
G127
#colors
blue: 0, 1, 2, 3, A, B
#initial
+++++++++
+A      +
+   +++ +
+ + +   +
+ + ++ ++
+ +     +
+ + + + +
+     + +
+2+++++ +
+       +
+ +++ + +
+   + + +
+ +B+++1+
+       +
+ ++ +3B+
+      0+
+++++++++
#goal
+++++++++
+       +
+   +++ +
+ + +   +
+ + ++ ++
+0+     +
+ + + + +
+     + +
+B+++++ +
+       +
+B+++ + +
+   + + +
+A+ +++ +
+     1 +
+ ++ +  +
+  3    +
+++++++++
#end
