#domain
hospital
#levelname
G131
#colors
blue: 0, B, D
#initial
+++++++++++++++
+   +       + +
+ + + +++++   +
+ + +     +   +
+ + + +++ +++ +
+ +   +   + + +
+++++ + +++ + +
+   +   +     +
+ + +0+++ +++++
+ B +     +   +
+ +D  +++++++ +
+ +   +     + +
+ +++++++ + + +
+         +   +
+++++++++++++++
#goal
+++++++++++++++
+   +       + +
+ + + +++++   +
+ + +     +   +
+ + + +++ +++ +
+ +   +   + + +
+++++ + +++ + +
+   +   +     +
+ + + +++ +++++
+ 0 +   D +   +
+ +   +++++++ +
+ +   +     + +
+ +++++++ + + +
+    B    +   +
+++++++++++++++
#end
