#domain
hospital
#levelname
G14
#colors
blue: 0, A
#initial
+++++++++
+       +
+ + + + +
+   + + +
+ +++ + +
+ +   + +
+++ +++A+
+   0   +
+ +++ +++
+   +   +
+ + +++++
+ + +   +
+ + + + +
+ + + + +
+ + + + +
+ +   + +
+ +++++ +
+       +
+++++++++
#goal
+++++++++
+       +
+ + + + +
+   + + +
+ +++ + +
+ +   + +
+++ +++ +
+       +
+ +++0+++
+   +   +
+ + +++++
+ + +   +
+ + + + +
+ + + + +
+ + + + +
+ +   + +
+ +++++ +
+       +
+++++++++
#end
