#domain
hospital
#levelname
G140
#colors
blue: 0, 1, D
#initial
+++++++++
+   + + +
+++   + +
+   +  0+
+ + 1 + +
+   D   +
+++++++++
#goal
+++++++++
+   + + +
+++ D + +
+   +   +
+ + 0 + +
+  1    +
+++++++++
#end
