#domain
hospital
#levelname
G141
#colors
blue: 0, 1, 2, 3, 4, 5
#initial
+++++++++++++++++
+       +   +   +
+ + 2+4++ + + + +
+ +     + +   + +
+ ++++5   +++++ +
+   +     1 +   +
+++    ++++ +++++
+3+ +0        + +
+ + +++ ++++  + +
+     +         +
+++++++++++++++++
#goal
+++++++++++++++++
+5      +   +   +
+ +  + ++ + + + +
+ +     + +   + +
+ ++++    +++++ +
+   +  32   +   +
+++    ++++ +++++
+ + +         + +
+ + +++ ++++  + +
+     +         +
+++++++++++++++++
#end
