#domain
hospital
#levelname
G143
#colors
blue: 0, 1, 2, 3
#initial
+++++++++++++++++++++
+     +   +     +   +
+ +++ + + + +++ +2+++
+   +   + + + + +   +
+ + ++++  + + +3+++ +
+ + +   + + + +  1+ +
+ + + + ++++  ++  + +
+     +   +  0  +   +
+ +++++++ + +++ +++ +
+       +     +     +
+++++++++++++++++++++
#goal
+++++++++++++++++++++
+    0+   +     +   +
+ +++ + + + +++ + +++
+   +   + + + + +   +
+ + ++++  + + + +++ +
+ + +   + + + +   + +
+ + + + ++++  ++  + +
+     +   +     +   +
+ +++++++ + +++ +++ +
+       +     +     +
+++++++++++++++++++++
#end
