#domain
hospital
#levelname
G165
#colors
blue: 0, 1, 2, 3, 4, A, B
#initial
+++++++++++
+       2 +
+  ++++ +++
+   0     +
+ + 3 ++A +
+ +     + +
+ +++++++ +
+ +   + + +
+ +       +
+ + +B  + +
+ + +++ + +
+ +  4+1  +
+++++ +++ +
+     +   +
+ + +A+ +++
+ +   A   +
+ +++++ + +
+   +     +
+++ +++ + +
+         +
+++++++++++
#goal
+++++++++++
+         +
+  ++++ +++
+         +
+ +   ++  +
+ +     + +
+ +++++++ +
+ +   + + +
+ +       +
+ + +   + +
+ + +++ + +
+ +   +   +
+++++ +++ +
+4    +   +
+ + + + +++
+3+       +
+ +++++ + +
+   +     +
+++ +++ + +
+AB       +
+++++++++++
#end
