#domain
hospital
#levelname
G166
#colors
blue: 0, A, C
#initial
+++++++++++++++++++
+       +         +
+ +++ + +++A  +++++
+     + + A       +
+++ + + +A+ +++++ +
+   + +     +   C +
+ +++ +++ + + +++ +
+   +A  +0+ +     +
+++ + + + +A+ + +++
+     +   + + +A  +
+ ++ ++++++ +++++ +
+        C        +
+++++++++++++++++++
#goal
+++++++++++++++++++
+   A   +         +
+ +++ + +++   +++++
+     + + C       +
+++ + + + + +++++ +
+  0+ +     +     +
+ +++ +++ + + +++ +
+   +  C+ + +     +
+++ + + + + + + +++
+   A +   + + +   +
+ ++ ++++++ +++++ +
+                 +
+++++++++++++++++++
#end
