#domain
hospital
#levelname
G167
#colors
blue: 0, 1, 2, 3
#initial
+++++++++
+       +
+  ++ + +
+ +   + +
+1+ +++ +
+   + 0 +
+ +++++ +
+ +     +
+ + +++ +
+ + +   +
+ +++ +++
+  2+   +
+ + +++ +
+     3 +
+ +++++++
+ +     +
+ +++ + +
+       +
+++++++++
#goal
+++++++++
+       +
+  ++ + +
+ +   + +
+ + +++ +
+   +   +
+ +++++ +
+ +     +
+ + +++ +
+ + +   +
+ +++ +++
+   +   +
+ + +++3+
+ 0   1 +
+ +++++++
+ +     +
+ +++ + +
+       +
+++++++++
#end
