#domain
hospital
#levelname
G171
#colors
blue: 0, 1, 2, 3, 4, A
#initial
+++++++++++++++++
+               +
+ + +A+ +++ +++ +
+ 1  3    +     +
+ 2  + ++ + + + +
+4    0 A +   + +
+++++++++++++++++
#goal
+++++++++++++++++
+               +
+ + + + +++ +++ +
+         +  A 2+
+ 0  + ++1+ + + +
+     3   +   + +
+++++++++++++++++
#end
