#domain
hospital
#levelname
G173
#colors
blue: 0, A
#initial
+++++++++
+ A     +
+++ +++ +
+   A   +
+ ++++  +
+ +   + +
+ + + +0+
+ + +   +
+ + +++ +
+       +
+ +++ + +
+     + +
+++++++++
#goal
+++++++++
+      A+
+++ +++ +
+       +
+ ++++  +
+ + 0 + +
+ + + + +
+ + +   +
+ + +++ +
+     A +
+ +++ + +
+     + +
+++++++++
#end
