#domain
hospital
#levelname
G174
#colors
blue: 0, 1, A, B
#initial
+++++++++++++++++++++
+     +             +
+ 0++ +++ +  ++++++ +
+B  +   + +     +   +
+ + +++A+++ + + +++ +
+A+   +       +A  + +
+  ++ + 1 +++++++ + +
+   +   +         + +
+A+ +++ + +++ +++++ +
+ +     + +     + + +
+  ++ + +++ A++ + + +
+     +       +   + +
+++++++++++++++++++++
#goal
+++++++++++++++++++++
+     +             +
+  ++ +++ +  ++++++ +
+   +   + +     +A  +
+ + +++ +++ + + +++ +
+ +   +     1 +   + +
+  ++ +   +++++++ + +
+   +   +     A A + +
+ + +++ +A+++ +++++ +
+ +     + +     + + +
+  ++ + +++  ++ + + +
+     +       +   + +
+++++++++++++++++++++
#end
