#domain
hospital
#levelname
G182
#colors
blue: 0, A, B, C, D
#initial
+++++++++++++++++++
+   0 A   +      C+
+ + + +++ +   +++++
+   +       D     +
+++ +++ ++ +++  +++
+     + C    B    +
+++++++++++++++++++
#goal
+++++++++++++++++++
+         +       +
+ + + +++ +   +++++
+   +    0        +
+++ +++ ++ +++  +++
+     +    C      +
+++++++++++++++++++
#end
