#domain
hospital
#levelname
G185
#colors
blue: 0, A
#initial
+++++++++++++++++
+     + A +A    +
+ +  +A + 0 +++ +
+   +   A +     +
+ +++  ++ +  ++++
+       +       +
+++++++++++++++++
#goal
+++++++++++++++++
+     +   +     +
+ + A+ 0+   +++ +
+  A+     +     +
+A+++  ++ +  ++++
+     A +       +
+++++++++++++++++
#end
