#domain
hospital
#levelname
G20
#colors
blue: 0, 1, 2, 3, 4, A, B, E
#initial
+++++++++++++
+           +
+ +++++ +++ +
+     +     +
++0+2 + +A+++
+4    +     +
+ + ++++ ++++
+     +  B  +
+++++   +++ +
+   + +   + +
+ +++A+ + + +
+ +       + +
+ + + +++++ +
+ + +       +
+ + ++++E + +
+ +     + + +
+ + + +1+ + +
+ +   +   + +
+ + + ++++3 +
+   +       +
+++++++++++++
#goal
+++++++++++++
+ E         +
+ +++++A+++ +
+     +     +
++ +  + + +++
+     +     +
+ + ++++ ++++
+     +     +
+++++   +++ +
+   + +   + +
+ +++ + + +4+
+ +       + +
+ + + +++++1+
+ +A+       +
+ + ++++  +3+
+ +0    + + +
+ + + + + + +
+ +   +   + +
+ + + ++++  +
+   +       +
+++++++++++++
#end
