#domain
hospital
#levelname
G209
#colors
blue: 0, 1, 2, 3, 4, A, B, C, D
#initial
+++++++++++++++++
+  B           3+
+    +  + + + + +
+1  A A     + D +
+ 4 +D+ +  +CB  +
+   20          +
+++++++++++++++++
#goal
+++++++++++++++++
+               +
+D   +  + + + +0+
+    B B C1 +   +
+   + + +3A+  2 +
+       D    A  +
+++++++++++++++++
#end
