#domain
hospital
#levelname
G213
#colors
blue: 0, 1, 2, 3, A
#initial
+++++++++
+       +
+3 0+++ +
+     + +
++A   +1+
+   +   +
+ +  2+ +
+    A+ +
+ + + + +
+   +   +
+++++++++
#goal
+++++++++
+2   1  +
+   +++ +
+     + +
++    + +
+   +   +
+ + 0 + +
+     + +
+A+ + + +
+   +   +
+++++++++
#end
