#domain
hospital
#levelname
G229
#colors
blue: 0, 1, 2, A, C
#initial
+++++++++++++++++++
+       +   +     +
+ + +++++ + + +++ +
+ +       +   +   +
+ ++++++ +C++++ + +
+ +             + +
+ + +++++++++++++ +
+ +       +     +A+
+++++++++ + ++++  +
+       + +   A   +
+ +++++++ + +++++++
+     +           +
+++++ +++ +++++++ +
+   +     + +     +
+ +++++++++ + ++ ++
+     +     + +   +
+ + +++ 1 +   + + +
+ +   + + + + + + +
+ +++ + + ++02+   +
+   +   +       + +
+++++++++++++++++++
#goal
+++++++++++++++++++
+       +   +     +
+ + +++++ + + +++ +
+2+       +1  +   +
+ ++++++ + ++++ + +
+ +             + +
+ + +++++++++++++ +
+ +       +     + +
+++++++++ + ++++  +
+       + +       +
+ +++++++ + +++++++
+     +           +
+++++ +++ +++++++ +
+   +     + +     +
+ +++++++++ + ++ ++
+     +     + +   +
+ + +++   +   + + +
+ +   + + + + + + +
+ +++ + + ++  +   +
+   +   +       + +
+++++++++++++++++++
#end
