#domain
hospital
#levelname
G23
#colors
blue: 0, D
#initial
+++++++++
+       +
+ +++++ +
+ +   + +
+ + +++ +
+ +     +
+  ++ +++
+ + + + +
+ + + + +
+ + +   +
+ +  0+ +
+   +  D+
+++++++++
#goal
+++++++++
+       +
+ +++++ +
+ +   + +
+ + +++ +
+ +     +
+  ++ +++
+ + + + +
+ + + + +
+ +D+   +
+ +0  + +
+   +   +
+++++++++
#end
