#domain
hospital
#levelname
G231
#colors
blue: 0, A, B
#initial
+++++++++++++++++
+ +   +       + +
+ +++ +++   + + +
+   + +  B+     +
+++ + A +++++++ +
+  B+ +     +   +
+ + + + +++ + +++
+ + + 0  A+ + + +
+ ++ + ++ + + + +
+           +   +
+++++++++++++++++
#goal
+++++++++++++++++
+0+   +       + +
+ +++ +++   + + +
+   +B+   +     +
+++ +   +++++++ +
+   + +     +   +
+ + + +A+++ + +++
+ + +     + + + +
+ ++ + ++ + + + +
+B          +   +
+++++++++++++++++
#end
