#domain
hospital
#levelname
G235
#colors
blue: 0, 1, 2, 3, A
#initial
+++++++++++++++++++++
+     +       +     +
+ +   + ++A + + +++ +
+ + +   +   + 3   + +
+ 1 + +++++ + + +++ +
+ 2 + +   + +   +   +
+ + + + +++ + +++  ++
+ + + +   + +   +   +
+ + + +++ + +++++++ +
+   + +   +A        +
+ +++++ ++++++++++  +
+ +     +     +   + +
+ + ++++  +++ +   + +
+ +   + +  A+   + + +
+ ++  + + + +++++++ +
+   + + + +         +
+ +++ + + +++++++++++
+     +0          A +
+++++++++++++++++++++
#goal
+++++++++++++++++++++
+     +       +  1  +
+ +   + ++  + + +++ +
+ + +   +   +     + +
+   + +++++ + + +++ +
+   + +   + +   +   +
+ + + +A+++ + +++  ++
+ + + +   + +   +   +
+ + + +++ + +++++++ +
+   + +   +         +
+ +++++ ++++++++++  +
+ +     +     +   + +
+ + ++++  +++ + A + +
+ +   + +   +   + + +
+ ++  + + + +++++++ +
+   +3+ + +         +
+ +++ + + +++++++++++
+     +             +
+++++++++++++++++++++
#end
