#domain
hospital
#levelname
G245
#colors
blue: 0, A, B, C
#initial
+++++++++++++++++
+           +   +
+B++++ ++++ + + +
+       +   +   +
+A+++++ ++C + + +
+     +   + + + +
+++ +++++ + ++  +
+   +    A+     +
+ + + +++ + +++++
+   + +   +    0+
+++ + A++++++++ +
+   +  C    +   +
+   +++++++ + +++
+         +     +
+++++++++++++++++
#goal
+++++++++++++++++
+           +   +
+ ++++ ++++ + + +
+       +   +   +
+ +++++ ++  + + +
+     +   + + + +
+++ +++++ +C++  +
+   +     +     +
+ + + +++ + +++++
+   + +   +     +
+++ +  ++++++++ +
+  B+       +   +
+   +++++++ + +++
+   A     +     +
+++++++++++++++++
#end
