#domain
hospital
#levelname
G250
#colors
blue: 0, A, C
#initial
+++++++++
+   +   +
+ + A +++
+ + +   +
+   +   +
+ + + + +
+ C   + +
+A+ + + +
+ + + + +
+ +   + +
+ +++++ +
+   0   +
+++++++++
#goal
+++++++++
+   +  0+
+ +   +++
+ + +   +
+   +   +
+ + + + +
+     + +
+ + + + +
+ + + + +
+ +   + +
+ +++++C+
+       +
+++++++++
#end
