#domain
hospital
#levelname
G272
#colors
blue: 0, C
#initial
+++++++++++++++++
+   + 0 + C     +
+ + + +++++++ + +
+ + +       + + +
+ ++ ++++++ + + +
+ +     + + + + +
+   + + + + +++ +
+ + + +   + +   +
+ + + +++++ + + +
+   +         + +
+++++++++++++++++
#goal
+++++++++++++++++
+   +   +       +
+ + + +++++++ + +
+ + +       + + +
+ ++ ++++++ + + +
+ +     + +0+ + +
+   + + + + +++ +
+ + + +   + +   +
+ + + +++++ + + +
+   +         + +
+++++++++++++++++
#end
