#domain
hospital
#levelname
G273
#colors
blue: 0
#initial
+++++++++++++++++
+      0  +     +
+ +++++++ + +++++
+     + +   +   +
+ + + + +++ + + +
+   + +     + + +
+ +++ + +++++ + +
+   + +   +   + +
+ +++ +++++ +++ +
+ +   +     + + +
+ + +++++++++ + +
+ +     +       +
+ +++++ + +++++++
+     +         +
+++++++++++++++++
#goal
+++++++++++++++++
+         +     +
+ +++++++ + +++++
+     + +   +   +
+ + + + +++ + + +
+   + +     + + +
+ +++ + +++++ + +
+   + +   +   + +
+ +++ +++++ +++ +
+ +   +     + + +
+ + +++++++++ + +
+ +     +       +
+ +++++ + +++++++
+     +         +
+++++++++++++++++
#end
