#domain
hospital
#levelname
G274
#colors
blue: 0, A, D
#initial
+++++++++
+ +   + +
+  ++ + +
+   + + +
+  0D + +
+ + A   +
+ +++ + +
+       +
+++++++++
#goal
+++++++++
+ +   + +
+ A++ + +
+   + + +
+     + +
+ +  D  +
+ +++ + +
+   0   +
+++++++++
#end
