#domain
hospital
#levelname
G278
#colors
blue: 0, 1, 2, 3, 4, 5, A, E, F, D
#initial
+++++++++++++++++++++
+   +       +       +
+   + +++ + + +++++5+
+ +   + 2 + + +    E+
+ +++ + ++  + + + + +
+   +     +   0 + + +
++  + ++  +++++ +  ++
+       +4    + +   +
+ + +++ + ++1++ ++  +
+    A+   +     +   +
+ + +3++A + D++++ +++
+ +F      +     A   +
+++++++++++++++++++++
#goal
+++++++++++++++++++++
+   + 4     +       +
+   + +++A+ + +++++ +
+ +   +   + + +     +
+F+++ + ++  + + + + +
+   +     +     +1+ +
++  + ++  +++++ +  ++
+       +     + +   +
+ + +++ + ++ ++ ++A +
+     + 2 +     +   +
+ + + ++  +  ++++ +++
+ +   5   +       3 +
+++++++++++++++++++++
#end
