#domain
hospital
#levelname
G280
#colors
blue: 0, A, B, E, C
#initial
+++++++++++++++++++++
+   +     A     +   +
+ + + + +++++++ + + +
+ +   +    E  +     +
+ +++++ +  +CA  +++ +
+  0+   +   + +     +
+++ + +++A+ +A ++ + +
+ +   +   B +     + +
+ + +++ +++ +++ +++ +
+               B   +
+++++++++++++++++++++
#goal
+++++++++++++++++++++
+ C +           +   +
+ + + + +++++++ + + +
+ +   +       +     +
+ +++++ +  +    +++ +
+   +   +   + +   A +
+++ + +++ +A+  ++A+ +
+ +B E+     +  B  + +
+ + +++ +++ +++ +++ +
+             B     +
+++++++++++++++++++++
#end
