#domain
hospital
#levelname
G29
#colors
blue: 0, 1, A, D
#initial
+++++++++++++++
+   A         +
+ + A++++ +++ +
+ +     +     +
+0+++++ + + + +
+   +A      + +
+1+   ++  +   +
+ + +     + + +
+++ ++++ D+D+ +
+   A       + +
+++++++++++++++
#goal
+++++++++++++++
+             +
+ +  ++++ +++ +
+ +     +    A+
+ +++++ + + + +
+   +       + +
+ +   ++  +   +
+ + +1    + + +
+++D++++  +A+ +
+          D+0+
+++++++++++++++
#end
