#domain
hospital
#levelname
G290
#colors
blue: 0, 1, A, D
#initial
+++++++++++++++
+ +     +     +
+ + + + ++++  +
+ + + +     + +
+ + + +++++ + +
+ A + +   + + +
+++++ +++ + + +
+     + D +   +
+ +++++ +++++ +
+   +         +
+++ + +++++++ +
+ + +     0 + +
+ + + +++++++ +
+ +   +     + +
+ +++ +++ +++ +
+       + A   +
+ +++++ + + +++
+ +       + + +
+  + ++++ 1 + +
+  A          +
+++++++++++++++
#goal
+++++++++++++++
+ +     +     +
+ + + + ++++  +
+ + + +     + +
+ + + +++++ + +
+   + +   + + +
+++++ +++ + + +
+     +   +   +
+ +++++ +++++ +
+   +         +
+++ + +++++++ +
+D+ +       + +
+A+ + +++++++ +
+ +   +     + +
+ +++ +++ +++ +
+       +     +
+A+++++ + + +++
+ +      1+ + +
+  + ++++   + +
+             +
+++++++++++++++
#end
