#domain
hospital
#levelname
G294
#colors
blue: 0, 1, 2, 3
#initial
+++++++++
+   +   +
+ + + + +
+ +  3  +
+++++++ +
+     + +
+ +++   +
+   + 1 +
+   0++ +
+       +
+ +++++++
+       +
+++++++++
#goal
+++++++++
+   +   +
+ + + + +
+ +     +
+++++++ +
+    2+ +
+ +++   +
+   +   +
+   0++ +
+       +
+ +++++++
+       +
+++++++++
#end
