#domain
hospital
#levelname
G300
#colors
blue: 0, 1, A, B
#initial
+++++++++++++++
+ +           +
+ + +++++++  ++
+   1       + +
+ + + + ++++B +
+ +   +0+  A+ +
+ + + +++   + +
+        A+   +
+++++++++++++++
#goal
+++++++++++++++
+ + 1         +
+ + +++++++  ++
+           + +
+ +0+ + ++++ A+
+ +   + +   + +
+ + + +++   + +
+   B     +   +
+++++++++++++++
#end
