#domain
hospital
#levelname
G309
#colors
blue: 0, 1, 2, 3, 4, 5, A
#initial
+++++++++++++++++
+           +   +
+ +++++ +++ + + +
+       +   +   +
+ ++A+++  +++ + +
+   1   +   +   +
+++   + + + + + +
+ 0   +   + 5 + +
+ ++++++++++  + +
+ + +      2+ + +
+ + + +++3+ +++ +
+ +   +4        +
+++++++++++++++++
#goal
+++++++++++++++++
+A   5      +   +
+ +++++ +++ + + +
+       +   +   +
+ ++ +++  +++ + +
+       +   +   +
+++   + + +3+ + +
+     +   +   + +
+ ++++++++++  + +
+2+ +       + + +
+ + + +++ + +++ +
+ +   +0        +
+++++++++++++++++
#end
