#domain
hospital
#levelname
G32
#colors
blue: 0, 1, 2, 3, 4, 5, A
#initial
+++++++++++++
+           +
+ + ++ ++ + +
+   2   +   +
+ ++0 + + + +
+ +   + + + +
+++1+++ +   +
+   + 5 + +3+
+ +++ +++ + +
+   + +   + +
+ + + + +++ +
+ +     +   +
+ ++++++  +++
+ A     +   +
+ + +++ +++ +
+   +    4  +
+++++++++++++
#goal
+++++++++++++
+      0    +
+ + ++ ++ + +
+       +   +
+ ++  +1+ + +
+ +   + + + +
+++ +++ +   +
+   +  4+ + +
+ +++ +++5+ +
+   + +   + +
+ + + + +++ +
+ +     +   +
+ ++++++  +++
+ A     +   +
+ + +++ +++ +
+   +     3 +
+++++++++++++
#end
