#domain
hospital
#levelname
G329
#colors
blue: 0, A, C, D
#initial
+++++++++++++++++++++
+     C +           +
+ +++++ + +++ + +++ +
+ +   + + + D   +   +
+ + + + + +++++++ +++
+   + +   +     + + +
+++++ +++ + +++   + +
+     +       + +   +
+ + +++ + +++++ +++ +
+   +     +     + + +
+ +++++++ + +++++ + +
+       + +   +     +
+++++0+ +++++ + +++++
+     A    A  +     +
+++++++++++++++++++++
#goal
+++++++++++++++++++++
+       +           +
+ +++++ + +++ + +++C+
+ +   + + +     +   +
+ + + + + +++++++ +++
+   + +   +     + + +
+++++ +++ + +++   + +
+     +       + +   +
+ + +++ + +++++ +++ +
+  A+     +     + + +
+ +++++++ + +++++ +A+
+       + +   +     +
+++++ + +++++ + +++++
+     0       +     +
+++++++++++++++++++++
#end
