#domain
hospital
#levelname
G336
#colors
blue: 0, A, D
#initial
+++++++++++
+         +
+ +++ +++ +
+   +   + +
+ + +++ + +
+ + +   + +
+++ +D+ + +
+   + +   +
+ +++++ + +
+ A   0 + +
+++++++++ +
+    A  + +
+ +++++++ +
+         +
+ +  ++++++
+       + +
+++++++ A +
+         +
+ +++++++ +
+         +
+++++++++++
#goal
+++++++++++
+         +
+ +++ +++ +
+   +   + +
+ + +++ + +
+ + + A + +
+++ + + + +
+   + +   +
+ +++++ + +
+       +0+
+++++++++ +
+       + +
+ +++++++ +
+         +
+ +  ++++++
+       + +
+++++++   +
+         +
+ +++++++ +
+  DA     +
+++++++++++
#end
