#domain
hospital
#levelname
G355
#colors
blue: 0, E
#initial
+++++++++++++++++
+ E +         + +
+ + + +++++++ + +
+ +   +     + + +
+ +0+++ +++ + + +
+     + + + + + +
++ ++ + +   +++ +
+     + + +   + +
+ + +++ + +++ + +
+ + +   +   +   +
+ +++ +++++ +++++
+               +
+++++++++++++++++
#goal
+++++++++++++++++
+   +         + +
+ + + +++++++ + +
+ +   +     + + +
+ + +++ +++ + + +
+     + + + + + +
++ ++ + +   +++ +
+     +E+ +   +0+
+ + +++ + +++ + +
+ + +   +   +   +
+ +++ +++++ +++++
+               +
+++++++++++++++++
#end
