#domain
hospital
#levelname
G364
#colors
blue: 0, 1, 2, 3, 4, A, B, D
#initial
+++++++++++++++++
+     +         +
+D+ +++ + ++++A++
+ +     +       +
+ +++++++++++++ +
+ +     +     + +
+ + +++ +3+++   +
+   +  4+ +   + +
++ ++2+++  ++++ +
+B  +   +   +   +
+0+ +++   + +++++
+     + +   A + +
+ +++ + +  ++ + +
+   + +   +     +
+ + +++++++ +++ +
+ +     1     + +
+ ++++D++   + + +
+ +     + +     +
+ +++ + + +++ + +
+     + +   D   +
+++++++++++++++++
#goal
+++++++++++++++++
+     +       D +
+ + +++ + ++++ ++
+ +     +       +
+ +++++++++++++D+
+ +     +     + +
+ + +++ + +++   +
+   +   + +   + +
++ ++ +++3 ++++ +
+   + 4 +   +   +
+ + +++   + +++++
+ 1   + +     + +
+ +++ + +  ++A+ +
+   + +   +     +
+ +D+++++++ +++ +
+ +           + +
+ ++++ ++   + + +
+ +     + + B   +
+ +++ + + +++2+ +
+     + +       +
+++++++++++++++++
#end
