#domain
hospital
#levelname
G381
#colors
blue: 0, 1, A
#initial
+++++++++
+     + +
+ 1 + + +
+ + + +A+
+ +++ + +
+       +
+ + + + +
+ +0    +
+++++++++
#goal
+++++++++
+     + +
+   +A+ +
+ + + + +
+ +++ + +
+    0  +
+ + + + +
+ +     +
+++++++++
#end
