#domain
hospital
#levelname
G401
#colors
blue: 0, B
#initial
+++++++++
+ B     +
+  ++++ +
+ +     +
+ + +++ +
+ 0 +   +
+++++++++
#goal
+++++++++
+      B+
+  ++++ +
+ +     +
+ + +++ +
+   + 0 +
+++++++++
#end
