#domain
hospital
#levelname
G404
#colors
blue: 0, 1, 2, 3, 4, B, E, C
#initial
+++++++++++++
+ +   1     +
+ +3+ +  ++ +
+ + + +   +E+
+ +  +++C++ +
+ +    B  + +
+ + ++++  2 +
+    B  +   +
+ 4 +   ++  +
+           +
+++++++++++++
#goal
+++++++++++++
+ +03       +
+ + + +  ++ +
+ + + +   + +
+B+  +++ ++ +
+ +       + +
+ + ++++    +
+ E     + B +
+   +   ++  +
+C          +
+++++++++++++
#end
