#domain
hospital
#levelname
G405
#colors
blue: 0, 1, 2, 3, 4
#initial
+++++++++++
+ +   +   +
+ +++ + +++
+     3   +
+ +++++   +
+   +     +
+++ + + + +
+ +   + + +
+  +2+4   +
+      01 +
+++++++++++
#goal
+++++++++++
+ + 0 +   +
+ +++ + +++
+         +
+ +++++   +
+   +     +
+++ +4+3+ +
+ +  1+ + +
+  + +   2+
+         +
+++++++++++
#end
