#domain
hospital
#levelname
G415
#colors
blue: 0, 1, A, C
#initial
+++++++++++++
+ + +       +
+ +  +C+  + +
+ +         +
+  ++++A0 + +
+  1     A  +
+++++++++++++
#goal
+++++++++++++
+ + +       +
+ +  +1+  + +
+0+ C       +
+  ++++   + +
+        A  +
+++++++++++++
#end
