#domain
hospital
#levelname
G424
#colors
blue: 0, A
#initial
+++++++++++
+     +0  +
+ +++ + + +
+ + +     +
+ + +++++ +
+   + A   +
+ A++ +++ +
+ +   +   +
+ + +++ A++
+ + +     +
+ + +++++ +
+ + +   + +
+ + + + + +
+ +   + + +
+ +++ + + +
+ +     + +
+   +++++ +
+   +A    +
+ + +++ + +
+ +     + +
+++++++++++
#goal
+++++++++++
+     +   +
+ +++ + + +
+ + +     +
+ + +++++ +
+   +     +
+  ++ +++ +
+ +   +   +
+ + +++  ++
+ +A+     +
+ + +++++ +
+ +0+   + +
+ + + + + +
+ +   + + +
+ +++ + + +
+ +     + +
+   +++++A+
+   +     +
+ + +++A+ +
+ +     + +
+++++++++++
#end
