#domain
hospital
#levelname
G426
#colors
blue: 0, 1, 2, 3, A, B, C
#initial
+++++++++++++++
+             +
+ +++  +++A+ ++
+ 3   +   2 + +
+ + ++  +++ + +
+ +   +   + + +
+ +++ +++ + +B+
+   +   C + + +
+++ + + + + + +
+ + +   + + + +
+ + +  ++ + + +
+ +1+     +   +
+ + +++++++++++
+ + A         +
+ +0  ++  +++ +
+     +       +
+++++++++++++++
#goal
+++++++++++++++
+            B+
+ +++  +++ + ++
+     +     + +
+A+ ++ 0+++ +2+
+ +   +   + + +
+ +++ +++ + + +
+   +     + + +
+++ + + + + + +
+ + +   + + + +
+ + +  ++ + + +
+ + +     +  A+
+ + +++++++++++
+ +           +
+ +   ++  +++ +
+     +       +
+++++++++++++++
#end
