#domain
hospital
#levelname
G427
#colors
blue: 0, 1, 2, E, C
#initial
+++++++++++++++++
+               +
+ +++ + + + +++ +
+ +   +  2  +   +
+ + +++++ + ++ ++
+ + +   + + +   +
+ + + + + + ++C +
+ +   +   +   + +
+ ++++++0 +++ + +
+         +   + +
+ +++++++++ +++ +
+   +   + +     +
+++ E + + +++++++
+   + +   1 +   +
+ +++ ++ ++ + +++
+     +   + +   +
+++++++C+++ +++ +
+               +
+++++++++++++++++
#goal
+++++++++++++++++
+       1       +
+ +++ + + + +++ +
+ +   +     +   +
+ + +++++ + ++ ++
+ + +   + + +   +
+ + + + + + ++  +
+ +   +   +   + +
+ ++++++  +++ + +
+         +   + +
+ +++++++++ +++ +
+   +   + +     +
+++   + + +++++++
+  C+ +     +   +
+ +++ ++ ++ + +++
+     +   + +   +
+++++++ +++ +++ +
+               +
+++++++++++++++++
#end
