#domain
hospital
#levelname
G43
#colors
blue: 0, A, B, C
#initial
+++++++++++++++++++++
+   C   +     +   + +
+ +++ + + +++ + + + +
+   + +   + +   +   +
+++++ +++++ ++++ ++ +
+     +       +   + +
+ +++++ ++B++ + + + +
+ +   +     +  A+   +
+ + + + +++++++ + +++
+   + + +     +     +
+++++ +++ +++ +++++ +
+ +   +   + +   + + +
+ + +++ + +  ++ + + +
+ +     +     + 0   +
+ +++++++ +++ +++ +++
+ +   +   + +     + +
+ + + + +++ +++++++ +
+   + + +       +   +
+ +++ + + +++++ +++ +
+   +     +         +
+++++++++++++++++++++
#goal
+++++++++++++++++++++
+       +     +   + +
+ +++ + + +++ + + + +
+ 0 + +   + +   +   +
+++++ +++++ ++++ ++ +
+     +       +   + +
+ +++++ ++ ++ + + +B+
+ +   +     +   +   +
+ + + + +++++++ + +++
+   + + +     +     +
+++++ +++ +++ +++++ +
+ +   +   + +   + + +
+ + +++ + +  ++ + + +
+ +     +     + A   +
+ +++++++ +++ +++ +++
+ +   +   + +     + +
+ + + + +++ +++++++ +
+   + + +       +   +
+ +++ + + +++++ +++ +
+   +     +     C   +
+++++++++++++++++++++
#end
