#domain
hospital
#levelname
G434
#colors
blue: 0, 1, A, C
#initial
+++++++++++
+      1  +
+ +++++++ +
+     C   +
+ +++++++ +
+ +   +   +
+ + +++ + +
+   +   + +
+++ + ++0 +
+        A+
+++++++   +
+     + + +
+ +++ +++ +
+   +     +
+ + +++++ +
+  A+     +
+ +++++++++
+         +
+ +++++++++
+         +
+++++++++++
#goal
+++++++++++
+     10  +
+ +++++++ +
+         +
+ +++++++ +
+ +   + A +
+A+ +++ + +
+   +   + +
+++ + ++  +
+         +
+++++++   +
+     + + +
+ +++ +++ +
+   +     +
+ + +++++ +
+   +     +
+ +++++++++
+     C   +
+ +++++++++
+         +
+++++++++++
#end
