#domain
hospital
#levelname
G435
#colors
blue: 0, 1, 2, A, C
#initial
+++++++++++++
+       +   +
+ +++ ++  + +
+ +       + +
+ + AC+++++ +
+ +     +   +
+  ++ + +++++
+     +   + +
+ +2+ + + + +
+ +1    +   +
+++++++++++++
#goal
+++++++++++++
+       +   +
+ +++ ++0 + +
+ +       + +
+ +   +++++ +
+ +     +   +
+  ++ + +++++
+     +   + +
+ + + + + + +
+ +   2 +   +
+++++++++++++
#end
