#domain
hospital
#levelname
G437
#colors
blue: 0, 1, A, B, D
#initial
+++++++++++++
+           +
+ + ++  + + +
+ +     B + +
+ ++++++  + +
+ +   0     +
+ + + + +++++
+ + +   +   +
+A+ +++ +++ +
+ + + + +   +
+ +B+ +1+ +++
+   + + +   +
+++ D   + + +
+   + + + + +
+  ++   +++ +
+   A + +   +
+ + + + + + +
+ +   +   + +
+++++++++++++
#goal
+++++++++++++
+           +
+ + ++  + + +
+ +       + +
+ ++++++  + +
+D+         +
+ + + + +++++
+ + +   +   +
+ + +++ +++ +
+ + + + +   +
+ + + + + +++
+ 0 +A+ +   +
+++     + + +
+   + + + + +
+  ++   +++ +
+     + +   +
+ + + + + + +
+ +   +   + +
+++++++++++++
#end
