#domain
hospital
#levelname
G44
#colors
blue: 0, A, B, C
#initial
+++++++++++++++++
+     +   +     +
+ +++     + +++++
+     + + +     +
+ +++   +  ++++ +
+   +   +  0+   +
++A +B+++++ +   +
+   +       + + +
+ +++ + +++++ + +
+ A   +     +C+ +
+ + + +B+ + + + +
+   +   C +C  + +
+++++++++++++++++
#goal
+++++++++++++++++
+A    +   +     +
+C+++     + +++++
+     + + +     +
+ +++ A0+  ++++ +
+   +   +   +  B+
++  + +++++ +   +
+   +       + + +
+ +++ + +++++ + +
+     +     + + +
+ + + + + + + + +
+   +     +   + +
+++++++++++++++++
#end
