#domain
hospital
#levelname
G441
#colors
blue: 0, B
#initial
+++++++++++++++++++
+     +           +
+ +++ + +++ +++++ +
+ +   +   + + +   +
+ + +++++ +++ 0 +++
+ + +     +   + + +
++  + +++++ +++ + +
+   +      B+   + +
+ +++++++++ +  ++ +
+   B             +
+++++++++++++++++++
#goal
+++++++++++++++++++
+     +           +
+ +++ + +++ +++++ +
+ +   +   + + +   +
+ + +++++ +++   +++
+ + +     +   + + +
++  + +++++ +++ + +
+   +     B +   + +
+ +++++++++ +  ++ +
+  0              +
+++++++++++++++++++
#end
