#domain
hospital
#levelname
G443
#colors
blue: 0, A, B, C
#initial
+++++++++++++++
+         +   +
+ ++B++++ + + +
+   +   +   + +
+++ +   ++++  +
+   + C       +
+ + +++++++++ +
+           + +
+++++A+++++ + +
+ +     +   + +
+ + + +++ +++ +
+ +       + + +
+ ++C++++++ + +
+   +     A0+ +
+ +   +   + + +
+ +   +   C   +
+++++++++++++++
#goal
+++++++++++++++
+         +   +
+ ++ ++++ + + +
+   +   +   + +
+++ +   ++++  +
+   +      B  +
+ + +++++++++ +
+           + +
+++++ +++++ + +
+ +     +   + +
+ + + +++ +++ +
+ +       + + +
+ ++ ++++++ + +
+ A +       + +
+ +   +   +A+ +
+ +   +       +
+++++++++++++++
#end
