#domain
hospital
#levelname
G449
#colors
blue: 0, 1, 2, 3, 4, 5, B, C
#initial
+++++++++++++++++++
+     +     +     +
+ + + + + +++ + + +
+   +   + C B + + +
+ ++++++C+++ ++ +++
+     +       +   +
+++++ + + +++ +++ +
+     +    0+ 5   +
+ +++ 2++   + + + +
+ +           4 + +
+++ ++++ +1 +++ + +
+               + +
+++++++++++++++++++
#goal
+++++++++++++++++++
+     +     +     +
+ + + + + +++ + + +
+  0+   +     + + +
+ ++++++ +++ ++ +++
+     +   C   +   +
+++++ + + +++ +++ +
+ B   +     +     +
+ +++  ++   + + + +
+ +    2 4      + +
+++ ++++ +  +++ + +
+               + +
+++++++++++++++++++
#end
