#domain
hospital
#levelname
G454
#colors
blue: 0, A, D
#initial
+++++++++++++
+   +       +
+ + + +++++ +
+ +     + + +
+  ++++++ + +
+ + +     + +
+ + + +++ + +
+ + +   +   +
+ + + + A +++
+ +   + +   +
+0+++D+ +++ +
+     +     +
+++++++++++++
#goal
+++++++++++++
+   +       +
+ + + +++++ +
+ +     +A+ +
+  ++++++ + +
+ + +     + +
+ + + +++ + +
+ + +   +   +
+ + + +   +++
+ +   + +   +
+ +++ + +++ +
+ 0   +     +
+++++++++++++
#end
