#domain
hospital
#levelname
G46
#colors
blue: 0, C
#initial
+++++++++++++++++
+ +     + +     +
+ + + +++  ++ + +
+ + +   +   + + +
+ + +++ +++ +++ +
+   + + +   +   +
+ +++ + + +++ +++
+ +   +   +     +
+ +++ +++++++++ +
+   +         + +
+++ +++++++   + +
+ +       + +   +
+ +++++++ + +++ +
+     C 0   +   +
+++++++++++++++++
#goal
+++++++++++++++++
+ +     + +     +
+ + + +++  ++ + +
+ +0+   +   + + +
+ + +++ +++ +++ +
+   + + +   +   +
+ +++ + + +++ +++
+ +   +   +     +
+ +++ +++++++++ +
+   +         + +
+++ +++++++   + +
+ +       + +C  +
+ +++++++ + +++ +
+           +   +
+++++++++++++++++
#end
