#domain
hospital
#levelname
G465
#colors
blue: 0, A, B
#initial
+++++++++++++++++++
+         +       +
+ +++++++ + 0+A + +
+   +   + + + + + +
+++ +++ + + + + + +
+ A   +   +   + + +
+ +   + +++B+++ + +
+   + +     +   + +
+ +++ +++ A++ +++ +
+     + +   + + + +
+ + +++ +++   + + +
+   +         +   +
+++++++++++++++++++
#goal
+++++++++++++++++++
+         +       +
+ +++++++ +  + A+ +
+   +   + + + + + +
+++ +++ + + + + + +
+     +   +   + + +
+ +   + +++ +++ + +
+  A+ +    A+   + +
+ +++ +++  ++ +++ +
+ 0   + +   + + + +
+ + +++ +++   + + +
+   +       B +   +
+++++++++++++++++++
#end
