#domain
hospital
#levelname
G486
#colors
blue: 0
#initial
+++++++++++++
+     +     +
+ +++ +++++ +
+   +     + +
+ + +++++ + +
+ +   +   + +
+  ++ + +++ +
+ +   +     +
+ + +++++++++
+ + +       +
+ + +++++++ +
+ +       + +
+ +++++ +++ +
+ +   + +   +
+ +0+ + + +++
+ + + +   + +
+ +++ +++++ +
+           +
+++++++++++++
#goal
+++++++++++++
+     +     +
+ +++ +++++ +
+   +     + +
+ + +++++ + +
+ +   +   + +
+  ++ + +++ +
+ +   +     +
+ + +++++++++
+ + +       +
+ + +++++++ +
+ +       + +
+ +++++ +++ +
+ +   + +   +
+ + + + + +++
+ + + +   + +
+ +++ +++++ +
+           +
+++++++++++++
#end
