#domain
hospital
#levelname
G494
#colors
blue: 0, 1, 2, 3, 4, 5, 6, A, B, C, D
#initial
+++++++++++++++++++
+       D     +   +
+  ++B+ + ++  +4+ +
+ +      C+ +   + +
+ ++++ ++++ +++++ +
+0A   +   +   1   +
+ +++ +++ +++++ +++
+   +   +  5  B + +
+ +++++ +++++ + + +
+           + + + +
+ + +++  ++++ + + +
+ +   + +    C+ + +
+ +++2+ +  + ++   +
+ A   + +       + +
+ + +++ +   +++ + +
+   +   + + +  A6 +
+ + +   + + + + + +
+ +       +   +  3+
+++++++++++++++++++
#goal
+++++++++++++++++++
+             +   +
+  ++ + + ++  + + +
+ +  4    + +   + +
+ ++++ ++++ +++++ +
+     +   +       +
+ +++ +++ +++++ +++
+   +   + C     + +
+ +++++ +++++ + + +
+           + + + +
+A+ +++A ++++ + + +
+ +   +6+     + + +
+ +++ + +  + ++   +
+     + +       + +
+ + +++ +   +++ + +
+   + 1 + + +     +
+ + +   + + +B+ + +
+ +       +   +A  +
+++++++++++++++++++
#end
