#domain
hospital
#levelname
G495
#colors
blue: 0, A, B, C
#initial
+++++++++++++++++++
+   A   +     +   +
+++++ C +++ + + + +
+   + +     +   + +
+ + + +++++++++++ +
+ +   +   +     + +
+ +++++ + + +++ + +
+   +   +     + + +
+++ + + +++++++ + +
+ +   +       +   +
+ +++++  ++++ +++ +
+     B   + +     +
+++++ +++ + +++ + +
+   +0+     +   + +
+++   + +++++ +++++
+   + + +   +     +
+  ++ + + + + +++ +
+   + + + + + +   +
+ + + +++ + +++ + +
+ +B      +     + +
+++++++++++++++++++
#goal
+++++++++++++++++++
+       +     +  A+
+++++   +++ + + + +
+   + +     +   + +
+ + + +++++++++++ +
+ +   +   +     + +
+ +++++ + + +++ + +
+   +   +     + + +
+++ + + +++++++ + +
+B+   +   0   +   +
+ +++++  ++++ +++ +
+       C + +     +
+++++ +++B+ +++ + +
+   + +     +   + +
+++   + +++++ +++++
+   + + +   +     +
+  ++ + + + + +++ +
+   + + + + + +   +
+ + + +++ + +++ + +
+ +       +     + +
+++++++++++++++++++
#end
