#domain
hospital
#levelname
G496
#colors
blue: 0, A
#initial
+++++++++++++++++++++
+       +     +     +
+ + +++ +++ +++ + +++
+ +   +     +   +   +
+ ++  +++++ + +++++ +
+ +   +   + + +   + +
+ + +++++ + + + +++ +
+ +     +   +   +   +
+ ++++  +++++ +++ +++
+ +   + +     + +   +
+ +++ + + +++++ +++ +
+     + +   +   +   +
+++++ + +++ + +++ + +
+  0  +  A  +     + +
+++++++++++++++++++++
#goal
+++++++++++++++++++++
+       +     +     +
+ + +++ +++ +++ + +++
+ +   +     +   +   +
+ ++  +++++ + +++++ +
+ +   +   + + +   + +
+ + +++++ + + + +++ +
+ +     +   +   +   +
+ ++++  +++++ +++ +++
+ +   + +     + +   +
+ +++ + + +++++ +++ +
+     + +   +   +   +
+++++ + +++ + +++ + +
+     +     +     + +
+++++++++++++++++++++
#end
