#domain
hospital
#levelname
G53
#colors
blue: 0, A
#initial
+++++++++++++++
+     +   A   +
+ +++ + ++++0 +
+ +   +   +   +
+ + +++++ + +++
+ +   +   + + +
+ +++ + + +++ +
+ +  A+ + +   +
+ +++ + + +++ +
+ A +   +   + +
++  +++++++ + +
+   +     +   +
+   + ++A +++ +
+ +   + +   + +
+ +++ + +++ + +
+             +
+++++++++++++++
#goal
+++++++++++++++
+     +       +
+ +++ + ++++  +
+ +   +   +   +
+ + +++++ + +++
+ +   +   + + +
+ +++ + + +++ +
+A+   + + +   +
+ +++ + + +++ +
+   +   +A  + +
++  +++++++ + +
+   +     +   +
+   + ++  +++ +
+ + A + +   + +
+ +++ + +++ + +
+             +
+++++++++++++++
#end
