#domain
hospital
#levelname
G54
#colors
blue: 0, 1, 2, A, B
#initial
+++++++++++
+    B+   +
+02 A   +++
+     1 + +
+    ++++ +
+         +
+++++++++++
#goal
+++++++++++
+     +   +
+       +++
+     2 + +
+    ++++ +
+ A   1  B+
+++++++++++
#end
