#domain
hospital
#levelname
G57
#colors
blue: 0, 1, A, B
#initial
+++++++++++++++
+       +     +
+ ++ ++ +++ +++
+ +       +   +
+ +++ +++ +++ +
+ + +     +   +
+ 1 + ++++  + +
+   + +  0  + +
+++++ +++ +++ +
+  A+     +   +
+ + +++++++ +++
+         + + +
+ +++ + + + +A+
+ +   +   + + +
+ + + +++++A+ +
+   +         +
+++++++++++++++
#goal
+++++++++++++++
+       +     +
+ ++ ++ +++ +++
+ +       +   +
+ +++ +++ +++ +
+ + +     +   +
+   + ++++  + +
+   + +     + +
+++++ +++ +++ +
+   + A   +   +
+B+ +++++++ +++
+         + + +
+ +++ + + + + +
+ +   +   + + +
+ + + +++++ + +
+   + 1  0    +
+++++++++++++++
#end
