#domain
hospital
#levelname
G63
#colors
blue: 0
#initial
+++++++++++++++++++
+ +       +       +
+ + +++++ +++++ + +
+ +   +       + + +
+ +++ +++++++ +++0+
+   +   +   +     +
+++ +++ + +++++++ +
+ +     + +     + +
+ +++++++ + +++ + +
+       + + + + + +
+ +++ + + + + + + +
+ +   + + + + +   +
+++ +++ + + + +++++
+   +     +     + +
+ +++++++++++++ + +
+ +   +       + + +
+ + + + + +++++ + +
+ + + + + +   +   +
+ + + + + + +  ++ +
+   +   +   +     +
+++++++++++++++++++
#goal
+++++++++++++++++++
+ +       +       +
+ + +++++ +++++ + +
+ +   +       + + +
+ +++ +++++++ +++ +
+   +   +   +     +
+++ +++ + +++++++ +
+ +     + +     + +
+ +++++++ + +++ + +
+       + + + + + +
+ +++ + + + + + + +
+ +   + + + + +   +
+++ +++ + + + +++++
+   +     +     + +
+ +++++++++++++ + +
+ +   +       + + +
+ + + + + +++++ + +
+ + + + + +   +   +
+ + + + + + +  ++ +
+   +   +   +     +
+++++++++++++++++++
#end
