#domain
hospital
#levelname
G69
#colors
blue: 0, A, B, C, F
#initial
+++++++++++++++++++
+ +               +
+ + +A+  ++++++++ +
+ +   +   +   +   +
+ + +++++ + + +++ +
+   +   + +     + +
+ +++ + + + +++ + +
+ +   + + +     + +
+++ +++B+ + +++ + +
+   +     + C   + +
+ ++0++++++    ++++
+ +   +     F     +
+ + + + +++++++++ +
+   +     +       +
+ +++++++++ +++++ +
+ +         +     +
+++++++++++++++++++
#goal
+++++++++++++++++++
+ +        B      +
+ + + +  ++++++++F+
+ +   +   +   +   +
+ + +++++ + + +++ +
+   +   + +     + +
+ +++ + + + +++ +0+
+ +   + + +     + +
+++ +++ + + +++ + +
+   +     +     + +
+ ++ ++++++    ++++
+ +   +   A       +
+ + + + +++++++++ +
+   +     +       +
+ +++++++++ +++++ +
+ +         +     +
+++++++++++++++++++
#end
