#domain
hospital
#levelname
G75
#colors
blue: 0, A, B, C
#initial
+++++++++++++
+C  +       +
+ + B +++ + +
+ +      A  +
+++++++ +++ +
+     + +   +
++B++  +  + +
+   0       +
+++++++++++++
#goal
+++++++++++++
+   +       +
+ +   +++ + +
+ +         +
+++++++ +++ +
+     + + B +
++ ++  +  + +
+    B      +
+++++++++++++
#end
