#domain
hospital
#levelname
G77
#colors
blue: 0, 1, 2, 3, 4, D
#initial
+++++++++
+   +   +
+ +++ + +
+     + +
+2+ +++ +
+ +   + +
+++ + + +
+   + + +
+ +++ + +
+ + + + +
+ + + + +
+0+     +
+ +  ++++
+ + +   +
+ +++ 3 +
+     + +
+ + + + +
+ +   + +
+ +  1+ +
+   4 D +
+++++++++
#goal
+++++++++
+   +   +
+1+++ + +
+     + +
+ + +++ +
+ +   + +
+++ + + +
+   + + +
+ +++ + +
+ + + + +
+ + + + +
+ +     +
+ +  ++++
+ + +   +
+ +++   +
+  3  + +
+ + + + +
+ +   + +
+ +   + +
+       +
+++++++++
#end
