#domain
hospital
#levelname
G82
#colors
blue: 0, B
#initial
+++++++++++++
+           +
+ +++++ +++++
+ + +   +   +
+ + + +++++ +
+   +     + +
+++ ++0++ + +
+ + +   +   +
+ + +++ +++++
+ +   +     +
+  ++ +++ + +
+     +   + +
+ +++++ +++++
+     +     +
+++++ + +++ +
+   + + + + +
+ +++ + + + +
+     B     +
+ +++++++++ +
+           +
+++++++++++++
#goal
+++++++++++++
+           +
+ +++++ +++++
+ + +   +   +
+ + + +++++ +
+   +     + +
+++ ++ ++ + +
+ + +   +   +
+ + +++ +++++
+ +   +     +
+  ++ +++ + +
+     +  B+ +
+ +++++ +++++
+     +     +
+++++ + +++ +
+   + + + + +
+ +++ + + + +
+           +
+ +++++++++ +
+           +
+++++++++++++
#end
