#domain
hospital
#levelname
G83
#colors
blue: 0, 1, 2, 3, A, B, C, D
#initial
+++++++++++++++++++++
+   3         A +   +
+   + ++ ++ + A ++  +
+   +  B+   2 +   + +
+A ++   +  B   +  + +
+     +   C      0D +
+++++++++++++++++++++
#goal
+++++++++++++++++++++
+ C DB          +   +
+   + ++ ++ +   ++  +
+   +   +     +   +A+
+  ++   +      +  + +
+     +A A  A       +
+++++++++++++++++++++
#end
