#domain
hospital
#levelname
G84
#colors
blue: 0, 1, C
#initial
+++++++++++++++++++
+ +     +    0+ + +
+ + + + + ++    + +
+ + + + + +   + + +
+ + + C++   +++ + +
+ 1 +     +       +
+++++++++++++++++++
#goal
+++++++++++++++++++
+ +     +     + + +
+ + + + + ++    + +
+ + + + + +   + + +
+ + +  ++   +++ + +
+   +     +       +
+++++++++++++++++++
#end
