#domain
hospital
#levelname
G89
#colors
blue: 0, 1, A, B, C
#initial
+++++++++++++++
+           + +
+ + + + +++ + +
+ + + +   +   +
+++   +++ ++  +
+   +  A  +   +
+ +++++++++ +++
+       +   + +
+++++++ +0+++ +
+   +   +     +
+ + + +++++++ +
+ +   +  C  + +
+ + +++ +++ + +
+ + +   + +   +
+ +++ ++  +++++
+     +       +
+ +++++++1+++ +
+ B     + +   +
+ +++ + +++ + +
+     +     + +
+++++++++++++++
#goal
+++++++++++++++
+B          + +
+ + + + +++ + +
+ + + +   +   +
+++   +++ ++  +
+   +     +   +
+ +++++++++ +++
+      C+   + +
+++++++ + +++ +
+   +   +     +
+ + + +++++++ +
+ +   +     + +
+ + +++ +++ + +
+ + +   + +   +
+ +++ ++  +++++
+   A +       +
+ +++++++ +++ +
+       + +   +
+ +++ + +++ + +
+     +     + +
+++++++++++++++
#end
