#domain
hospital
#levelname
G91
#colors
blue: 0, A, B, D
#initial
+++++++++++++++++++
+   + +     +     +
+ +++   +++ + +++ +
+AB   +   +     + +
+ +   + +++++++ + +
+ + +   +  0  +D+ +
+ + ++ ++ +++ +++ +
+        D        +
+++++++++++++++++++
#goal
+++++++++++++++++++
+   + +     +     +
+ +++   +++ + +++ +
+     +   +     +D+
+ +   + +++++++ + +
+ + +0  +B    + + +
+ + ++ ++D+++ +++ +
+            A    +
+++++++++++++++++++
#end
