#domain
hospital
#levelname
G98
#colors
blue: 0, 1, 2, 3, A
#initial
+++++++++++
+  1  +   +
+ + +A  2++
+     +   +
+ +  ++3+ +
+  0      +
+++++++++++
#goal
+++++++++++
+     + 2 +
+ + +    ++
+     + 10+
+ +  ++ +A+
+       3 +
+++++++++++
#end
