#domain
hospital
#levelname
G102
#colors
blue: 0, A, B, C
#initial
+++++++++++
+         +
+ +++ +++ +
+   +   + +
+++ ++  + +
+ +   + + +
+ + + +  ++
+ +   +  B+
+ + ++0 + +
+ +  A+ + +
+ +++ ++  +
+   + +   +
+ +++ + + +
+   +   +C+
+ + +++++ +
+ + +    C+
+ + + +++++
+ +       +
+++++++++++
#goal
+++++++++++
+         +
+ +++ +++ +
+ C +   + +
+++ ++  + +
+ +   + + +
+ + + +  ++
+ +   +   +
+ + ++  + +
+ +   + + +
+ +++ ++  +
+   + +0  +
+ +++ + + +
+   +   + +
+ + +++++ +
+ + +     +
+ + + +++++
+ +      C+
+++++++++++
#end
