#domain
hospital
#levelname
G106
#colors
blue: 0, A, B, C, D
#initial
+++++++++++++++++++++
+   +       +       +
+ + + +B+++   +++++ +
+ + + +     +     + +
+ +++ + +++++ +++++ +
+   + + +     +   + +
+     + 0 +++++ +   +
+     +   + +   +   +
+ +++++++D+ + +++++++
+ +   +     +   + + +
+ + + +++ C++++ + + +
+   +   +     +   + +
+++++++ + +B+++++++ +
+     + + + +       +
+++ +++ + + + +++++ +
+   +   + +     +   +
+ A++ ++++++ ++++ + +
+                 + +
+++++++++++++++++++++
#goal
+++++++++++++++++++++
+   +       +       +
+ + + + +++   +++++ +
+ + + +     +     + +
+ +++ + +++++ +++++ +
+   + + +     +   + +
+     +   +++++ +A  +
+     +   + +   +   +
+ +++++++D+ + +++++++
+ +   +     +   + + +
+ + + +++  ++++B+ + +
+   +   +     +   + +
+++++++ + + +++++++ +
+     + + + +       +
+++ +++ + + + +++++ +
+   +   + +    B+   +
+  ++ ++++++ ++++ + +
+                 + +
+++++++++++++++++++++
#end
