#domain
hospital
#levelname
G109
#colors
blue: 0, 1
#initial
+++++++++
+     10+
+ +++ + +
+     + +
+++++ + +
+       +
+++++++ +
+       +
+++++++++
#goal
+++++++++
+ 0     +
+ +++ + +
+     + +
+++++ + +
+       +
+++++++ +
+       +
+++++++++
#end
