#domain
hospital
#levelname
G114
#colors
blue: 0, A, B
#initial
+++++++++++++++
+   +   + +   +
+ + + + + +++ +
+   + + +     +
+ + + + +++++ +
+ + A +       +
+ + + ++++0++++
+ + + +   B   +
+ +++ + +++++ +
+   + +   +   +
+   + + +   +++
+ +   + + +   +
+ +++++ + +++ +
+     + + + + +
+++++ +++ + + +
+         +   +
+++++++++++++++
#goal
+++++++++++++++
+   +   + +   +
+ + + + + +++ +
+  B+ + +     +
+ + + + +++++ +
+ +   +       +
+ + + ++++ ++++
+ + + +       +
+ +++ + +++++ +
+   + +   +   +
+   + + +   +++
+ +   + + +   +
+ +++++ + +++ +
+     + + + + +
+++++ +++ + + +
+         +   +
+++++++++++++++
#end
