#domain
hospital
#levelname
G116
#colors
blue: 0, A, B
#initial
+++++++++++++++++
+               +
+ + +++++ +++++ +
+   +     +     +
+ +++ +++++ +++++
+   +   + + +   +
+A+++++ + + + + +
+ +   + + +   + +
+   + + + +++++++
+ + + 0 +       +
+ + +++ +++++++ +
+ + +       +   +
+ +  ++++++ + +++
+ +   +     +   +
+ +++ +++++++++ +
+   +          B+
+++++++++++++++++
#goal
+++++++++++++++++
+               +
+ + +++++ +++++ +
+   +    B+     +
+ +++ +++++ +++++
+   +   + + +   +
+ +++++A+ + + + +
+ +   + + +   + +
+   + + + +++++++
+ + +   +       +
+ + +++ +++++++ +
+ + +       +   +
+ +  ++++++ + +++
+ +   +     +   +
+ +++ +++++++++ +
+   +           +
+++++++++++++++++
#end
