#domain
hospital
#levelname
G12
#colors
blue: 0, B, C, D
#initial
+++++++++++++++++++++
+       +          C+
+ +++ + +++++ +++++++
+   + +     + +0    +
+++ + +++++ + + +++ +
+   + + +   + +   + +
+ + + + + +++ + + + +
+ + + + +   + + +B  +
+ +++ + +++ + + + + +
+     +   + +   + + +
+++++ + + + + +++ + +
+ +     + +     + +D+
+ + + + + +C+++ + +++
+ + +B+ +       +   +
+ + + +++ +++ +++++ +
+ + +  B  +         +
+ + +++++++++++ + + +
+               +   +
+++++++++++++++++++++
#goal
+++++++++++++++++++++
+       +           +
+ +++B+ +++++ +++++++
+ B + +     + +     +
+++ + +++++ + + +++ +
+   + + +   + +   + +
+ + + + + +++ + +B+ +
+ + + + +   + + +   +
+ +++ + +++ + + + + +
+     +   + +   + + +
+++++ + + + + +++ + +
+ +     + +     + + +
+ + + + + + +++ + +++
+ + + + +     0 +   +
+ + + +++ +++ +++++ +
+ + +     +         +
+ + +++++++++++ + + +
+               +  C+
+++++++++++++++++++++
#end
