#domain
hospital
#levelname
G124
#colors
blue: 0, A, B
#initial
+++++++++++++++
+     +       +
+++++ + +++ + +
+     + + + + +
+ ++ ++ + + + +
+     +   + + +
+ +++ + +++ + +
+ +   + + + + +
+++ + + + + +++
+   + + + +   +
+ +++0+ + + + +
+ +     + + + +
+ + +++++ +++ +
+ + +   +     +
+ + + + +++++++
+   +         +
+  ++ +++++ + +
+   +   +   B +
+++ +++++ +++ +
+ A       +   +
+++++++++++++++
#goal
+++++++++++++++
+     +       +
+++++ + +++ + +
+   B + + + + +
+ ++ ++ + + + +
+     +   + + +
+ +++ + +++ + +
+ +   + + + + +
+++ + + + + +++
+   + + + +   +
+ +++ + + + + +
+ +     + + + +
+ + +++++ +++ +
+ + +   +     +
+ + + + +++++++
+   +         +
+  ++ +++++ + +
+   +   +     +
+++ +++++ +++ +
+         +   +
+++++++++++++++
#end
