#domain
hospital
#levelname
G13
#colors
blue: 0, A, C
#initial
+++++++++++++++++++
+   +C           C+
+ + +++++++ +++++ +
+ +     0   +   + +
+ +++++++++++++ + +
+       +       + +
+++++++ + +++++++ +
+           +   + +
+ ++++++++  +   + +
+     +   +   + + +
+ +++ + + +++++  ++
+ + +   A     +   +
+ + +++++++ +++++ +
+ +       + +     +
+ + +++ +   + +++++
+ + +   + +   +C  +
+ +++ +++ +++++++ +
+   + + + +       +
+ + + +A+ +++ +++ +
+     +       +   +
+++++++++++++++++++
#goal
+++++++++++++++++++
+   +C            +
+ + +++++++ +++++ +
+ +         +   + +
+ +++++++++++++ + +
+ 0     +     C + +
+++++++ + +++++++ +
+           +   + +
+ ++++++++  +   + +
+     +   +   + + +
+ +++ + + +++++  ++
+ + +         +   +
+ + +++++++ +++++ +
+ +   A   + +A    +
+ + +++ +   + +++++
+ + +C  + +   +   +
+ +++ +++ +++++++ +
+   + + + +       +
+ + + + + +++ +++ +
+     +       +   +
+++++++++++++++++++
#end
