#domain
hospital
#levelname
G139
#colors
blue: 0, A, C
#initial
+++++++++++++++++++
+                 +
+ ++++ +++++++A++ +
+ +     +     +   +
+ + +++  ++++ + +++
+   + +   +   +   +
+ +++ +++ + +++++ +
+C    + + + +   + +
++ ++ + + + + + + +
+ +   + + +   + + +
+ + ++  + + +0+ + +
+     +   +   + A +
+++++++++++++++++++
#goal
+++++++++++++++++++
+                 +
+ ++++A+++++++0++ +
+ +     +     +   +
+ + +++  ++++ + +++
+   + +   +   +   +
+ +++ +++ + +++++ +
+ A   + + + +   + +
++ ++ + + + + + + +
+ +   + + +   + + +
+ + ++  + + + + + +
+     +   +   +   +
+++++++++++++++++++
#end
