#domain
hospital
#levelname
G146
#colors
blue: 0, 1, B
#initial
+++++++++
+   +   +
+++0  + +
+ + 1B  +
+ +  ++ +
+       +
+++++++++
#goal
+++++++++
+1  +   +
+++   + +
+ +     +
+ +0 ++ +
+  B    +
+++++++++
#end
