#domain
hospital
#levelname
G147
#colors
blue: 0, 1
#initial
+++++++++++++++
+     +     1 +
+ +   +++++  ++
+ + +     +   +
+++ +++++ +++ +
+   +   +  0  +
+ +++ + +++++ +
+     +     + +
+++++++++++++ +
+             +
+++++++++++++++
#goal
+++++++++++++++
+     +       +
+ +   +++++  ++
+ + +0    +   +
+++ +++++ +++ +
+   +   +     +
+ +++ + +++++ +
+     +     + +
+++++++++++++ +
+    1        +
+++++++++++++++
#end
