#domain
hospital
#levelname
G149
#colors
blue: 0, A
#initial
+++++++++++++++++
+           +   +
+ +++++++++ + + +
+     +       + +
+ +++ +++++++++ +
+   +     +   + +
+++++++++ + +++ +
+      A+ +     +
+ + +++ +   +++++
+ +     + + +   +
+ +++++ + + + + +
+     +   + + + +
+ +++ +++++ + + +
+   +     + + + +
+++ +++++ + + + +
+ + +   +0+   + +
+ + +++ + +++++ +
+       +     + +
+++++++++++++++++
#goal
+++++++++++++++++
+           +   +
+ +++++++++ + + +
+     +       + +
+ +++ +++++++++ +
+   +     +   + +
+++++++++ + +++ +
+       + +     +
+ + +++ +   +++++
+ +     + + +   +
+ +++++ + + + + +
+     +   + + + +
+ +++ +++++ + + +
+   +     + + + +
+++ +++++ + + + +
+ + +   + +   + +
+ + +++ + +++++ +
+       +     + +
+++++++++++++++++
#end
