#domain
hospital
#levelname
G150
#colors
blue: 0, 1, 2, 3, 4, 5, A
#initial
+++++++++++
+       + +
+ +++++ + +
+   +5+   +
+3+ +  ++++
+ +0+     +
+ + + +++ +
+ + + +   +
+   + + 4++
+     +   +
+ + + + +A+
+     +2  +
+ +++ 1 + +
+     +   +
+++++++++++
#goal
+++++++++++
+       + +
+ +++++ + +
+   + +   +
+ + +  ++++
+ + +  3  +
+ +2+ +++ +
+0+ + +   +
+   + +  ++
+A    +   +
+ + + + + +
+     +   +
+ +++   + +
+     +   +
+++++++++++
#end
