#domain
hospital
#levelname
G156
#colors
blue: 0, 1, 2, 3, 4, C
#initial
+++++++++++
+1   0  + +
+ +++ +++ +
+ +   +   +
+ +++++  ++
+   +3  + +
+++ + +   +
+   C     +
+ ++ ++++ +
+   +     +
+++ + 4+ ++
+   + +   +
+ +++ +++ +
+   +     +
+2+ +++++ +
+         +
+++++++++++
#goal
+++++++++++
+       + +
+ +++3+++ +
+ +   +   +
+ +++++  ++
+   +   +C+
+++ + +   +
+   1     +
+ ++ ++++ +
+   +     +
+++ +  + ++
+2  + +  0+
+ +++ +++ +
+   +     +
+ + +++++ +
+         +
+++++++++++
#end
