#domain
hospital
#levelname
G161
#colors
blue: 0, 1, B
#initial
+++++++++++++++
+             +
+ B+++++++ ++ +
+1      +     +
+  ++ + + +++++
+     0 +     +
+++++++++++++++
#goal
+++++++++++++++
+   0         +
+  +++++++ ++ +
+       +   B1+
+  ++ + + +++++
+       +     +
+++++++++++++++
#end
