#domain
hospital
#levelname
G162
#colors
blue: 0, 1, 2, B
#initial
+++++++++++++++++++++
+         +         +
+ ++++++1++ +++ +++++
+       +     +   + +
+ 02 +  + +++++++ + +
+ +   + + +       + +
+ ++  + + + + +++++ +
+ B   +     +       +
+++++++++++++++++++++
#goal
+++++++++++++++++++++
+         +         +
+ ++++++ ++ +++ +++++
+       +     +   + +
+    +  + +++++++ + +
+ +   + + +       + +
+ ++  + + + + +++++ +
+     +     +       +
+++++++++++++++++++++
#end
