#domain
hospital
#levelname
G163
#colors
blue: 0, A, B, C, D
#initial
+++++++++++++++++++
+   +           + +
+ +  ++++B+ +++ + +
+ +       +   +   +
+ +++ +++ + +++++ +
+ +   +D+   +   BC+
+ + ++ 0 ++ + +++++
+ +B+ +   A +     +
+ + + + ++++++ ++ +
+ + +           + +
+ + + +++ +++++++ +
+ +     +         +
+ +++++ + + +++++++
+       + +     + +
+ +++++D+++++++ + +
+                 +
+++++++++++++++++++
#goal
+++++++++++++++++++
+   +           + +
+ +  ++++ + +++ + +
+ +   0   +   +   +
+ +++ +++ + +++++ +
+ +   + +   +     +
+ + ++   ++ + +++++
+ + + +     +B    +
+ + + + ++++++ ++C+
+ + +           + +
+ + + +++ +++++++D+
+ +     +         +
+ +++++ + +A+++++++
+       + +B    + +
+ +++++ +++++++ + +
+     B           +
+++++++++++++++++++
#end
