#domain
hospital
#levelname
G169
#colors
blue: 0, 1, B
#initial
+++++++++
+    1  +
+  + ++ +
+B    + +
+++++++ +
+ +   + +
+   + + +
+   +   +
+0+B++ ++
+       +
+++++++++
#goal
+++++++++
+       +
+  + ++ +
+     + +
+++++++ +
+ +   + +
+   + + +
+   +   +
+ + ++ ++
+       +
+++++++++
#end
