#domain
hospital
#levelname
G170
#colors
blue: 0, 1, 2, 3, A, B, E
#initial
+++++++++++
+ +  A+   +
+ + +3+ + +
+ + +     +
+ + +++++ +
+E  +   + +
+ + + 1   +
+   + +   +
+++++ + + +
+ 0   +   +
+ +  ++++ +
+ + +B    +
+   + +++++
+ + +     +
+ + +++++ +
+ +   +   +
+ +++++ +++
+   2     +
+++++++++++
#goal
+++++++++++
+ +  3+   +
+ + + + + +
+ + +     +
+1+ +++++ +
+   +   + +
+ + + B   +
+   + +   +
+++++ + + +
+     +   +
+ +  ++++ +
+ + +     +
+   + +++++
+ + +     +
+ + +++++ +
+ +   +   +
+ +++++ +++
+    2    +
+++++++++++
#end
