#domain
hospital
#levelname
G172
#colors
blue: 0, A, E
#initial
+++++++++++++++++++
+     +           +
+ +++++ +++++ +++++
+       +   +     +
+ +++++++++ +++++ +
+ +     0     + + +
+ + +++ +++ + E + +
+ +   + +   +   + +
+ +++ + + +++++ + +
+   + + + +    A+ +
+++ + + + + +++++ +
+   + + +     +   +
+ +++++ + +++ + + +
+       +   + + + +
+ +++++++ + + + +++
+ +       + + +   +
+ + +++++++ +++++ +
+ +               +
+++++++++++++++++++
#goal
+++++++++++++++++++
+     +           +
+ +++++ +++++ +++++
+       +   +  0  +
+ +++++++++ +++++ +
+ +           + + +
+ + +++ +++ +   + +
+ +   + +   +   + +
+ +++ + + +++++ + +
+   + + + +     + +
+++ + + + + +++++ +
+   + + +     +   +
+ +++++ + +++ + + +
+       +   + + + +
+ +++++++ + + + +++
+ +       + + +   +
+ + +++++++ +++++ +
+ +               +
+++++++++++++++++++
#end
