#domain
hospital
#levelname
G176
#colors
blue: 0, 1, A, B, C, D
#initial
+++++++++++++++++++
+A+     +         +
+ + +B+ +++++ +++ +
+ + +   +   + +   +
+ + + + + + +++ + +
+ + + +   +C  D + +
+ + + ++0 +++++++ +
+ + +       +   + +
+ + + +++++ + +   +
+  C+       + + + +
+++++ +++++++B+   +
+     +       +   +
+ +++++ +++++  ++++
+       +   +     +
+ +++++  +1 +++++ +
+     +     +     +
+++++++++++++++++++
#goal
+++++++++++++++++++
+ +     +         +
+ + + + +++++ +++ +
+ + +   +   + +   +
+ +1+ + + + +++ + +
+ + + +   +     + +
+ + + ++  +++++++ +
+ + +C      +   + +
+ + + +++++ + +   +
+D  +       + + + +
+++++ +++++++ +   +
+     +   0   +   +
+ +++++ +++++  ++++
+       +   +     +
+ +++++  +  +++++ +
+     +     +   B +
+++++++++++++++++++
#end
