#domain
hospital
#levelname
G179
#colors
blue: 0, 1, A, B, C
#initial
+++++++++++++++++++
+                 +
+ + +++ + +++++ + +
+ +   +   +   + + +
+ +++ +++  ++ + + +
+     +    A  + + +
+ +++++++ + +++ + +
+ C     A + +   + +
++1+++  ++B + +++++
+   + +     +     +
+ +++ + +  +++++  +
+         +   +   +
+ +++++++ + +0+ + +
+ +   +   + +   +B+
+ + + +++++ ++++B +
+   +  B    +     +
+++++++++++++++++++
#goal
+++++++++++++++++++
+                 +
+A+ +++ + +++++ + +
+ +   +   +   + + +
+ +++ +++  ++ + + +
+     +       + + +
+ +++++++1+ +++ + +
+         + +   + +
++ +++  ++  + +++++
+   + +     +     +
+ +++ + +  +++++  +
+         +   +   +
+ +++++++ + + + + +
+ +   +   +C+   + +
+ + + +++++ ++++  +
+   +       +   A +
+++++++++++++++++++
#end
