#domain
hospital
#levelname
G181
#colors
blue: 0, A, C
#initial
+++++++++++++++
+   +   +   + +
+ + + + + + + +
+ +   + + +   +
+ ++++  +  ++ +
+ +     A   + +
+ + +++++++++ +
+ + +       + +
+ + +++++ + + +
+A+   +  C+ + +
+ +++ + ++A + +
+ + +   +   + +
+ + + +++ +++ +
+ + + +   0   +
+ + + + +++++++
+     +     + +
+ +++++++++ + +
+   +     +   +
+ + + + + +++ +
+ +     +     +
+++++++++++++++
#goal
+++++++++++++++
+   +   +   + +
+ + + + + + + +
+ +   + + +  0+
+ ++++  +  ++ +
+ +         + +
+ + +++++++++ +
+ + +       + +
+ + +++++ + + +
+ +   +   + + +
+ +++ + ++  + +
+ + +   +   + +
+ + + +++ +++ +
+ + + +       +
+A+ + + +++++++
+     +     + +
+ +++++++++ +A+
+   +     +   +
+ + + + + +++ +
+ +     +     +
+++++++++++++++
#end
