#domain
hospital
#levelname
G186
#colors
blue: 0, 1, B
#initial
+++++++++++++++++
+       +   +   +
+ B++ +++++ + + +
+   +     + + + +
+++ +++   + + + +
+ +   +   +   + +
+ 01+ + + B+  + +
+     B +       +
+++++++++++++++++
#goal
+++++++++++++++++
+       +   +   +
+  ++ +++++ + +B+
+   +     + + + +
+++ +++   + + + +
+ + B + B +   + +
+   + + +  +  + +
+       +    1  +
+++++++++++++++++
#end
