#domain
hospital
#levelname
G190
#colors
blue: 0, A, D
#initial
+++++++++++++++++
+       +   +   +
+ +++++ + + + +++
+ +     + + +  0+
+++ ++D++ + +++ +
+   +     +     +
+ +++ +++++A+ + +
+ +   +     +   +
+ + + +++ +++++ +
+ + +     +   + +
+ +++ ++++  + + +
+           +   +
+++++++++++++++++
#goal
+++++++++++++++++
+       +   +   +
+ +++++ + + + +++
+ +0    + + +   +
+++ ++ ++ + +++ +
+   +     +     +
+ +++ +++++ + + +
+ +   +     +   +
+ + + +++ +++++ +
+ + +     +   + +
+ +++ ++++  + + +
+      D    +   +
+++++++++++++++++
#end
