#domain
hospital
#levelname
G191
#colors
blue: 0, B, E, C
#initial
+++++++++++++++++++
+     +           +
+ +++ + +++++++ + +
+ + + +   +   +   +
+++ +   + + + +0+ +
+     + +   +   + +
+ +++++++++++++ + +
+   E +         + +
+++ + + + + +++B+ +
+       +   +   C +
+++++++++++++++++++
#goal
+++++++++++++++++++
+     +           +
+ +++ + +++++++ + +
+ + + + B +   +   +
+++ +   + + + + + +
+     +C+ 0 +   + +
+ +++++++++++++ + +
+     +         + +
+++ + + + + +++ + +
+       +   +     +
+++++++++++++++++++
#end
