#domain
hospital
#levelname
G192
#colors
blue: 0, 1, 2
#initial
+++++++++++++
+  1+       +
+ + + +2+++++
+ + + +     +
+ + +++++ + +
+ +     + + +
+ +++++ +0+ +
+   + + + + +
+++ + + +++ +
+   + +     +
++ ++ +++++ +
+           +
+ +++++ ++  +
+     +     +
+++++++++++++
#goal
+++++++++++++
+   +       +
+0+ + + +++++
+ + + +     +
+ + +++++ + +
+ +     + + +
+ +++++ + + +
+   + + + + +
+++ + + +++ +
+   + +     +
++ ++ +++++ +
+           +
+ +++++ ++  +
+     +     +
+++++++++++++
#end
