#domain
hospital
#levelname
G195
#colors
blue: 0, A, B, E, C
#initial
+++++++++++++++++++
+ +     +  A+     +
+C+ ++ ++ + + + + +
+ +     + +   + + +
+ +++++ +++++ + +++
+  0+   +   + +   +
+++   +++ + + +++ +
+   +  B  + + + + +
+ +++ +++ + + + + +
+   +   + + +   + +
+ + +E+ + + +++++ +
+ +   + + +       +
+++ +++   ++++++A +
+   +   + +       +
+ ++  +++E+ +++ + +
+         +       +
+++++++++++++++++++
#goal
+++++++++++++++++++
+ +     +   +     +
+ + ++ ++ + + + + +
+ +     + +   + + +
+ +++++ +++++ + +++
+   +   +   + +   +
+++   +++ + + +++ +
+   +     + + +E+ +
+ +++ +++ + + + + +
+A  +   + + +E  + +
+ + + + + + +++++ +
+ +   + + +       +
+++ +++   ++++++  +
+   +   + +       +
+ ++  +++ + +++ + +
+      C  +       +
+++++++++++++++++++
#end
