#domain
hospital
#levelname
G199
#colors
blue: 0, A, C, D
#initial
+++++++++++++
+ A     +   +
+ 0 +++  +  +
+ + + +   + +
+ + + +++ +D+
+ + +       +
+ + ++++ ++ +
+         + +
+ ++++++  + +
+   +A+ + + +
++C A + + + +
+ + + + + + +
+ + +   + + +
+     +   + +
+++++++++++++
#goal
+++++++++++++
+       +   +
+  A+++ 0+  +
+ + + +   + +
+ + + +++ +A+
+ + +       +
+ + ++++ ++ +
+         + +
+ ++++++  + +
+   + + + + +
++    + + + +
+ + + + + + +
+ + +   + + +
+     +   + +
+++++++++++++
#end
