#domain
hospital
#levelname
G200
#colors
blue: 0, 1, 2, 3, 4, 5, A, B, D
#initial
+++++++++++++++++++
+             +  B+
+   ++1++ +++D+ 3 +
+   +   + + +     +
+5+ 2 + + + +++++ +
+ +   +       +   +
+  +A+++++++ ++ +++
+     +  B+     + +
+++++ + + + +++ + +
+   +   +     +   +
+ +++++++ +++ + + +
+       +     +   +
+   +++++++++ +++ +
+ 0            4  +
+++++++++++++++++++
#goal
+++++++++++++++++++
+             +   +
+ 1 ++ ++ +++ +  A+
+ 0 +   + + +     +
+ +   + + + +++++ +
+ +   + B     +   +
+  + +++++++ ++ +++
+     +   +     + +
+++++ + + + +++ + +
+   +   +     +   +
+ +++++++ +++ + + +
+       +     +   +
+   +++++++++B+++2+
+          D      +
+++++++++++++++++++
#end
