#domain
hospital
#levelname
G203
#colors
blue: 0, 1, 2, 3, 4, 5
#initial
+++++++++++++++++
+  3+ +         +
+ + +   +++ +++ +
+ +2 1+ 4   + + +
+0+ +++5+   +   +
+           +   +
+++++++++++++++++
#goal
+++++++++++++++++
+   + +         +
+ + +   +++ +++ +
+ +   +     + + +
+ + +++ +   +   +
+        4 1+ 3 +
+++++++++++++++++
#end
