#domain
hospital
#levelname
G204
#colors
blue: 0, B, D
#initial
+++++++++++++++++++
+   +    0  +   + +
+ + +++ +++++ + + +
+ +     +     +   +
+ +++++ + +++++++ +
+   +   + +       +
+++ +++++ +++++ + +
+   +   +     +   +
+ +++ + +++B++ D+++
+   + +       + + +
+ + + +++ +++ + + +
+ +     +         +
+++++++++++++++++++
#goal
+++++++++++++++++++
+   +       +   + +
+ + +++ +++++ + + +
+ +     +     +   +
+ +++++ + +++++++ +
+   +   + +       +
+++ +++++ +++++ + +
+   +   +     +   +
+ +++ + +++ ++  +++
+   + +       + + +
+ + + +++ +++ + + +
+ +     +         +
+++++++++++++++++++
#end
