#domain
hospital
#levelname
G205
#colors
blue: 0, 1, A, B
#initial
+++++++++
+   +   +
+ + +A+ +
+ +   0 +
+ +++   +
+ +     +
+   + + +
+1B +   +
+++++++++
#goal
+++++++++
+   +   +
+A+ + + +
+ +     +
+ +++   +
+ +     +
+   + + +
+   +   +
+++++++++
#end
