#domain
hospital
#levelname
G208
#colors
blue: 0, 1, B, C, D
#initial
+++++++++++++++
+ +  C+      D+
+   + B + +++ +
+   +   + +   +
+ + + +++ +++++
+ + +   +     +
+ + + +++++++0+
+   +   +   + +
+ ++  + + + +1+
+     +   +   +
+++++++++++++++
#goal
+++++++++++++++
+ +  C+       +
+   +   + +++ +
+   +   + +   +
+ + + +++ +++++
+ + +   +B    +
+ + + +++++++ +
+   +   +   + +
+ ++  + + + + +
+     +   +   +
+++++++++++++++
#end
