#domain
hospital
#levelname
G210
#colors
blue: 0, A, B, D
#initial
+++++++++++++++
+    A+       +
+ ++  + + ++  +
+   +   + +   +
+++  +++  + +++
+ +     + + + +
+ 0A+++ A +++ +
+ +     +     +
+ + +++ +++++++
+ +   B + D   +
+ + +++++ +++ +
+         +   +
+++++++++++++++
#goal
+++++++++++++++
+     +     A +
+ ++  + + ++  +
+   +   + + A +
+++  +++  + +++
+ +     + + + +
+   +++   +++ +
+ +     +     +
+0+ +++ +++++++
+ +     +     +
+ + +++++ +++ +
+         + B +
+++++++++++++++
#end
