#domain
hospital
#levelname
G212
#colors
blue: 0, 1, 2, 3, 4, A
#initial
+++++++++++++++++++++
+                   +
+ +++++ + +++++++++ +
+   + + +   +   +   +
+++ + +  A+ + + + + +
+    A+   + + +   + +
+ +++4+0+ + +  ++++ +
+   +   + + +   + + +
+ +A+ + +   +++ + + +
+ +   + + + 1   + + +
+++ +++ ++  + +++ + +
+   + +     +   +  2+
+ +++ +++++++ + ++A +
+       + +   +   + +
+++3+++ + + +++++ + +
+   +   +       + + +
+   + +++A++ ++ +   +
+ + + +   +   + + + +
+ +++ + + + + + + + +
+       +   +     + +
+++++++++++++++++++++
#goal
+++++++++++++++++++++
+A                  +
+ +++++ +A+++++++++0+
+   + + +   +   +   +
+++ + +   + + + + + +
+     +   + + +   + +
+ +++ + + + + 3++++ +
+   +   + + +   + + +
+ + + + +   +++ + + +
+ +   + + +     + + +
+++ +++ ++  + +++ + +
+   + +4A   +   +   +
+ +++ +++++++ + ++  +
+       + +   +   + +
+++ +++ + + +++++ + +
+   +   +       + + +
+   + +++ ++ ++ +   +
+ + + +   +   + + + +
+ +++ + + + + + + + +
+       + A + 1   +2+
+++++++++++++++++++++
#end
