#domain
hospital
#levelname
G215
#colors
blue: 0, 1, 2, A
#initial
+++++++++++++
+ + A     + +
+ + ++++  + +
+ 2 +   +   +
+   +  1+0+ +
+     +     +
+++++++++++++
#goal
+++++++++++++
+ +      A+ +
+ + ++++  + +
+   +   +1  +
+   +   + + +
+ 0   +     +
+++++++++++++
#end
