#domain
hospital
#levelname
G218
#colors
blue: 0, 1, B, D
#initial
+++++++++++++++++++++
+         +       + +
+++++++ + +++ +++ + +
+ B           + +   +
+ 0++++++B ++++ +++ +
+ +   +     +   +   +
+ + +   +++ + + + +++
+ D + +   + + + + + +
+ + + +++   + +++ + +
+ + +     + +       +
+ + +++++++ + + +++ +
+ +     +   + +     +
+ +++++ + +++++++++ +
+     + +         + +
+ + +++ +++++++++ + +
+ +             + + +
+ +++++++++++++++ + +
+   +           1 + +
+++++++++++++++++++++
#goal
+++++++++++++++++++++
+         +  1    + +
+++++++ + +++ +++ + +
+             + +   +
+  ++++++  ++++ +++ +
+ +   +     +  0+   +
+ + +   +++ + + + +++
+   + +   + + + + + +
+ + + +++   + +++ + +
+ + +     + +       +
+ + +++++++ + +B+++ +
+ +     +   + +     +
+ +++++ + +++++++++ +
+     + +         + +
+ + +++ +++++++++ + +
+ +             + + +
+ +++++++++++++++ + +
+   +             + +
+++++++++++++++++++++
#end
