#domain
hospital
#levelname
G22
#colors
blue: 0, 1, A, B, C
#initial
+++++++++++++++++++
+       A +     1 +
+   + + +  ++ +++ +
+ +  CB   +   +   +
+ +C ++B+++ +++ +++
+ +     +   +   + +
+B+ +++++ + +  ++ +
+ + +A  +   + +   +
+ 0 + + + + + + + +
+     +   +     + +
+++++++++++++++++++
#goal
+++++++++++++++++++
+     B   +     B +
+   + + +  ++ +++ +
+ +     A +   +   +
+ +  ++ +++ +++ +++
+ +     +   +   + +
+ + +++++ + +  ++ +
+ + +   +   + +   +
+1  + + + + + + + +
+    0+   +     + +
+++++++++++++++++++
#end
