#domain
hospital
#levelname
G222
#colors
blue: 0, A, E, C
#initial
+++++++++++++
+         + +
+ + +++++ + +
+ +       + +
+ +A++++++  +
+       +  E+
+++++++ +A+ +
+     +   + +
+ +++  ++  A+
+   +   +   +
++  +++C+++ +
+ 0 + +   + +
+ ++  + +++ +
+     +     +
+++++++++++++
#goal
+++++++++++++
+         + +
+ + +++++ + +
+ +  E    + +
+ + ++++++  +
+   A   +   +
+++++++ + + +
+     +  A+ +
+ +++  ++   +
+   +   +   +
++  +++ +++ +
+   +0+   + +
+ ++  + +++ +
+     + A   +
+++++++++++++
#end
