#domain
hospital
#levelname
G225
#colors
blue: 0, A, E, C, D, B
#initial
+++++++++++++++++++
+ +             + +
+ +   +++ + +++ + +
+   +   B   +     +
+ +B+++ +++++++++ +
+ +   +       +   +
+ + +D+++++++ +++ +
+   +     + +   + +
+++++ +++ + ++A + +
+   + + +  C  + + +
+ 0 + + +++++ +  ++
+ +         + +   +
+ ++++ ++ +  ++++ +
+         +       +
+++++++++++++++++++
#goal
+++++++++++++++++++
+ +             + +
+ +   +++ + +++ + +
+   +       +     +
+B+ +++ +++++++++ +
+ +   +       +   +
+ + + +++++++ +++ +
+   +     + +   + +
+++++ +++ + ++  + +
+   + + +     + + +
+   + + +++++ +  ++
+ +         + +   +
+ ++++ ++ +  ++++ +
+  A      +   D   +
+++++++++++++++++++
#end
