#domain
hospital
#levelname
G228
#colors
blue: 0, A, C
#initial
+++++++++++++
+ +         +
+ + +++++++ +
+   +    0  +
+ + + + + + +
+   + +   + +
+ +++ +++++++
+ +   +     +
+ + + + +++++
+C+ + + +   +
+ + ++  + +++
+ + +   +   +
+++ + +++++ +
+   + +   + +
+ + + + A + +
+ + +   +   +
+ +++++++++ +
+           +
+++++++++++++
#goal
+++++++++++++
+ +         +
+ + +++++++ +
+   +       +
+ + + +C+ + +
+   + +   + +
+ +++ +++++++
+ +0  +     +
+ + + + +++++
+ + + + +   +
+ + ++  + +++
+ + +   +   +
+++ + +++++ +
+   + +   + +
+ + + +   + +
+ + +   +   +
+A+++++++++ +
+           +
+++++++++++++
#end
