#domain
hospital
#levelname
G232
#colors
blue: 0, 1, 2, B
#initial
+++++++++++++++++
+   +       +   +
+ ++0 +++ + + + +
+   + + + +  1+ +
+++   + + ++++  +
+   +   +   +   +
+ + +++ +++ +++++
+ +   + + +     +
+ + +++ + +++++ +
+B      +     + +
+ +++ + + 2++ + +
+ + +   + +   + +
+ + +++++++ +++ +
+           +   +
+++++++++++++++++
#goal
+++++++++++++++++
+   +       +   +
+ ++  +++ + + + +
+   + +1+ +   + +
+++   + + ++++  +
+   +   +   +   +
+ + +++ +++ +++++
+ +   + + +     +
+ + +++ + +++++ +
+     0 +     + +
+ +++ + +  ++ + +
+ + +   + +   + +
+ + +++++++ +++ +
+           +   +
+++++++++++++++++
#end
