#domain
hospital
#levelname
G241
#colors
blue: 0, A, B, C
#initial
+++++++++++++++
+     +   C   +
+ +++ + + +++++
+   +   +     +
+++ ++ ++++++B+
+   +     A   +
+ + + +++++ + +
+ + +     + + +
+ + +  ++ + +++
+ + +   +     +
+ + ++0++ ++  +
+ + +     +   +
+ + + + +++ +++
+ +   + + +   +
+ + + + + +++B+
+     A +     +
+++++++++++++++
#goal
+++++++++++++++
+ B   +A      +
+ +++ + + +++++
+   +   +  A  +
+++ ++ ++++++ +
+   +         +
+ + +0+++++ + +
+ + +     + + +
+ + +  ++ + +++
+ + +   +     +
+ + ++ ++ ++  +
+ + +     +   +
+ + + + +++ +++
+ +   + + +   +
+ + + + + +++ +
+       +     +
+++++++++++++++
#end
