#domain
hospital
#levelname
G244
#colors
blue: 0, A, C
#initial
+++++++++++++++++
+     +   +     +
+ + + + + + ++A +
+ + + + + +   + +
+ + + +++ +++ + +
+ + +  0    + + +
+ + +++++++++ + +
+ +       +   + +
+ +++  ++ + +++ +
+ + +     +   + +
+ + + +++++++++ +
+ + C +       A +
+ + + + ++ ++++++
+ + + + +     + +
+ + +   +++ + + +
+   +       +   +
+++++++++++++++++
#goal
+++++++++++++++++
+     +   +     +
+ + + + + + ++  +
+ + + + + +   + +
+ + + +++ +++A+ +
+ + +       + + +
+ + +++++++++ + +
+ +  A    +   + +
+ +++  ++ + +++ +
+ + +     +   +0+
+ + +C+++++++++ +
+ +   +         +
+ + + + ++ ++++++
+ + + + +     + +
+ + +   +++ + + +
+   +       +   +
+++++++++++++++++
#end
