#domain
hospital
#levelname
G246
#colors
blue: 0, 1, B, E, C
#initial
+++++++++++++
+ +         +
+ + ++ ++ + +
+E+ +     + +
+ + + + +++ +
+   +     + +
+  ++++++ +++
+       +   +
+++++++ 1++++
+     + +   +
+ ++ ++ +  ++
+     + +   +
+ + + + +++ +
+   +   +   +
+C++B++++ + +
+B    0   + +
+++++++++++++
#goal
+++++++++++++
+ +0        +
+ + ++ ++ + +
+ + +     + +
+ + + +B+++ +
+   +     + +
+  ++++++ +++
+       +   +
+++++++  ++++
+     + + B +
+ ++ ++ +  ++
+     + +   +
+ + + + +++ +
+   +   +   +
+ ++ ++++E+ +
+         + +
+++++++++++++
#end
