#domain
hospital
#levelname
G25
#colors
blue: 0, A, C
#initial
+++++++++++++++
+             +
+++ + + + +++ +
+     + + +   +
+A+++++ C + +++
+      0+ +   +
+ + +++++ +++ +
+ +       + + +
+++ +++ +A+ + +
+   +         +
+++++++++++++++
#goal
+++++++++++++++
+         A   +
+++ + + + +++ +
+     + + +   +
+ +++++ 0 + +++
+       + +   +
+ + +++++ +++ +
+ +       + + +
+++ +++ + + + +
+   +         +
+++++++++++++++
#end
