#domain
hospital
#levelname
G252
#colors
blue: 0, 1, 2, 3, 4, 5, A, B, D
#initial
+++++++++++++++++++
+   D   A   + 5   +
+ +++ + + + + + + +
+ +   +   +   +  1+
+   +2+ + +++3 ++ +
+B+  4    +   +A  +
+ +++ +  ++++++ + +
+            0    +
+++++++++++++++++++
#goal
+++++++++++++++++++
+ 0    1   D+     +
+ +++ + + + + + + +
+ +   +   +   +4  +
+  A+ + + +++  ++ +
+ +       +   +   +
+ +++ +  ++++++ +A+
+         B  2    +
+++++++++++++++++++
#end
