#domain
hospital
#levelname
G253
#colors
blue: 0, 1, B, C
#initial
+++++++++++
+       1 +
+ +++++++ +
+ +     + +
+ + +++ + +
+   + +   +
+ +++ +++B+
+   + +   +
+     + +++
+C    +   +
+++ + +++ +
+  0+     +
+++++++++++
#goal
+++++++++++
+      C  +
+ +++++++ +
+ +     + +
+ + +++ + +
+   + +  0+
+ +++ +++ +
+   + +   +
+     + +++
+     +   +
+++ + +++ +
+   +     +
+++++++++++
#end
