#domain
hospital
#levelname
G26
#colors
blue: 0, A, B, F, D
#initial
+++++++++++
+   B     +
+ +++ +++++
+ +   +D  +
+ + +++ + +
+ + +   + +
+ + + +++ +
+ +   +   +
+++++++ + +
+       + +
+ +++++++ +
+   +     +
+ + + +++++
+ + + +   +
+++ +++ + +
+   +   +F+
+  ++  A+ +
+     +   +
+ + +++0  +
+       + +
+++++++++++
#goal
+++++++++++
+         +
+ +++ +++++
+ +   +  B+
+ + +++ + +
+ + +   + +
+ + + +++ +
+ +   +   +
+++++++ + +
+       + +
+ +++++++ +
+   +     +
+ + + +++++
+ + + +   +
+++ +++ + +
+   +   + +
+  ++   + +
+     +   +
+ + +++   +
+       + +
+++++++++++
#end
