#domain
hospital
#levelname
G261
#colors
blue: 0, A, B, D
#initial
+++++++++++
+       + +
+ +++ + + +
+ + +     +
+ +   + + +
+   +   + +
+ +++ + +++
+   + 0   +
+ + +++++ +
+A+       +
+++++++++ +
+     +   +
+ ++ ++ +++
+ +     + +
+ + +D+++ +
+   +     +
+ +++++++ +
+     +   +
+B+A+ + + +
+       + +
+++++++++++
#goal
+++++++++++
+       + +
+ +++ + + +
+ + +     +
+ +   + + +
+   +   + +
+A+++ + +++
+0  +     +
+ + +++++ +
+ +       +
+++++++++ +
+     +   +
+ ++ ++ +++
+ +  D  + +
+ + + +++ +
+   +     +
+ +++++++ +
+     +   +
+ + + + + +
+       +B+
+++++++++++
#end
