#domain
hospital
#levelname
G27
#colors
blue: 0, 1, A
#initial
+++++++++++++
+ 0   +   + +
+ + + + + + +
+ + +   +   +
+ + +A+++++ +
+         + +
+ ++ ++++ + +
+   +   1 + +
+++ + + + + +
+     + +   +
+++++++++++++
#goal
+++++++++++++
+     +   + +
+ + + + + + +
+ + +   +   +
+ + + +++++ +
+         + +
+ ++ ++++ + +
+   +     + +
+++ + + + + +
+     + +   +
+++++++++++++
#end
