#domain
hospital
#levelname
G275
#colors
blue: 0, A
#initial
+++++++++++++
+       +   +
+ +++++ +  ++
+     + +   +
+ + + 0 +++ +
+ + +     + +
+ +++++++ + +
+     + +   +
+++++++ +++ +
+   +     + +
+ +++ +++ + +
+   +   +   +
++A +++ +++++
+     +     +
+ ++++ ++++A+
+           +
+++++++++++++
#goal
+++++++++++++
+       +   +
+ +++++ +  ++
+     + +   +
+ + +   +++ +
+ + +     + +
+ +++++++ +A+
+     + + 0 +
+++++++ +++ +
+   +     + +
+ +++ +++ + +
+   +   +   +
++  +++ +++++
+     +     +
+ ++++ ++++ +
+           +
+++++++++++++
#end
