#domain
hospital
#levelname
G276
#colors
blue: 0, C
#initial
+++++++++++++++
+             +
+ + +++++++++ +
+ +         + +
+0+ +C+++++ + +
+ + +     + + +
+ +   + C + + +
+ + + + + + + +
+ + +++ +++ + +
+ +     +   + +
+ + +++ + +++ +
+       + +   +
+++++++++++++++
#goal
+++++++++++++++
+             +
+ + +++++++++ +
+ +         + +
+ + + +++++ + +
+ + +     + + +
+ +   +   + + +
+ + + + + + + +
+ + +++ +++C+ +
+ +     +   + +
+ + +++ + +++ +
+0  C   + +   +
+++++++++++++++
#end
