#domain
hospital
#levelname
G28
#colors
blue: 0, A, B, C
#initial
+++++++++
+       +
+ +++ + +
+     + +
+++++   +
+   + + +
+ A +++ +
+ +   + +
+ +++ + +
+ +     +
+ +++++ +
+ B     +
+ + +++ +
+       +
+++++ +++
+   + +C+
+ + + + +
+ +    0+
+++++++++
#goal
+++++++++
+       +
+ +++ + +
+     +A+
+++++   +
+   + + +
+   +++ +
+ +   + +
+ +++ + +
+ +     +
+ +++++B+
+       +
+ + +++ +
+       +
+++++ +++
+   + + +
+ + + + +
+ +     +
+++++++++
#end
