#domain
hospital
#levelname
G282
#colors
blue: 0, 1, 2, A, B
#initial
+++++++++++++++
+    B    +   +
+ +++++++ +   +
+ +   +   +   +
+ + +++ +++++ +
+   + + +     +
+ + + + + + + +
+   +   +2+ + +
++ ++0++ ++ + +
+   +     1 + +
+ + +++++ + + +
+ +   +   A + +
+ +++ + +++ + +
+   +       + +
+++++++++++++++
#goal
+++++++++++++++
+         +   +
+ +++++++ +   +
+ +   +   +   +
+ + +++ +++++ +
+   + + + 1   +
+ + + + + + + +
+   +   + + + +
++ ++ ++ ++ + +
+   +       + +
+ + +++++ + + +
+ +   +     + +
+ +++ + +++ + +
+   + A    0+ +
+++++++++++++++
#end
