#domain
hospital
#levelname
G283
#colors
blue: 0, A, B
#initial
+++++++++++++++
+B   0+       +
+ +++A+ + +++ +
+ +   +     + +
+ + + + +++++ +
+ + + + +     +
+ + + + +++++ +
+ + + +     + +
+ +  ++++++ + +
+ +           +
+++++++++++++++
#goal
+++++++++++++++
+     +       +
+ +++ + + +++ +
+ +   +     + +
+ + + + +++++ +
+ + + + +     +
+ + + + +++++ +
+ + +0+     + +
+ +  ++++++ + +
+ +           +
+++++++++++++++
#end
