#domain
hospital
#levelname
G285
#colors
blue: 0, A
#initial
+++++++++++
+         +
+++++ + + +
+   + + + +
+ +++++ + +
+ +   + + +
+ + + + + +
+ + +   + +
+ + + ++0 +
+ +   +   +
+ + + +++++
+ + +A    +
+ ++++ ++ +
+   + A + +
++  + + + +
+ + + + + +
+ + + + + +
+     +   +
+++++++++++
#goal
+++++++++++
+         +
+++++ + + +
+   + + + +
+ +++++ + +
+ +   + + +
+ + + + + +
+ + +   + +
+ + + ++  +
+ +   +   +
+ + + +++++
+ + +     +
+ ++++ ++ +
+   +   + +
++  + + + +
+ + + + + +
+ + + + + +
+     +   +
+++++++++++
#end
