#domain
hospital
#levelname
G289
#colors
blue: 0, A, B
#initial
+++++++++++++++
+      A      +
+ +++++ +++++ +
+BB +   +   + +
+ + + +++++ +++
+   +     +   +
+++ +++++ +A+ +
+ + +       + +
+ + + +   ++0 +
+ +     +     +
+ + + + +++ +++
+     +       +
+++++++++++++++
#goal
+++++++++++++++
+     A  A    +
+ +++++ +++++ +
+   +   +   + +
+ + + +++++ +++
+   +     +   +
+++ +++++ + + +
+ + +       + +
+ + + +   ++  +
+ +     +   0 +
+ + + + +++ +++
+     +       +
+++++++++++++++
#end
