#domain
hospital
#levelname
G291
#colors
blue: 0, 1, 2, A, B
#initial
+++++++++++++++++++++
+ +       1         +
+   +++++ +++ +   + +
+A  +   + +     + + +
+++++ +++ + +++ +++ +
+     +   +   + A + +
+ +++ ++++ 0+ ++B + +
+             +  2  +
+++++++++++++++++++++
#goal
+++++++++++++++++++++
+ +             A   +
+   +++++ +++ +   + +
+   +   + +     + + +
+++++ +++ + +++ +++ +
+   1 +   +   +   + +
+ +++ ++++  + ++  + +
+             +     +
+++++++++++++++++++++
#end
