#domain
hospital
#levelname
G292
#colors
blue: 0, A, B, C
#initial
+++++++++++++++++
+             + +
+++ ++  ++++C + +
+ A   + +     + +
+++++ + +++  ++ +
+ +   +   + +   +
+ +  ++ 0 + +++ +
+   +   + +     +
+ +++++++ + +A+ +
+         +     +
+++++++++++++++++
#goal
+++++++++++++++++
+ A    B      + +
+++ ++  ++++  + +
+     + +     + +
+++++ + +++  ++ +
+ +   +   + +   +
+ +  ++   + +++ +
+   +   + +     +
+ +++++++ + + + +
+         +C    +
+++++++++++++++++
#end
