#domain
hospital
#levelname
G298
#colors
blue: 0, 1, 2, 3, 4, 5, A, C
#initial
+++++++++++++++++++++
+AA      C   5     1+
+2+++  ++++ +++++++ +
+       3   +     0 +
+ +A+ ++++4++ +   A +
+       +   A    A  +
+ +++++   +  + ++++ +
+    A    +         +
+++++++++++++++++++++
#goal
+++++++++++++++++++++
+    A              +
+ +++  ++++ +++++++ +
+A          + 2 0   +
+ + + ++++ ++ +     +
+  A  3A+     A     +
+ +++++   +  + ++++ +
+         +A5       +
+++++++++++++++++++++
#end
