#domain
hospital
#levelname
G299
#colors
blue: 0, A, C
#initial
+++++++++++++++
+     +       +
+ + +++ +++++ +
+ +   +     + +
+ +++ +++ +++ +
+  C      +   +
+++ +A+++++ +++
+     +     + +
+ ++A  ++++++ +
+   +       + +
+ +++++++++ + +
+         +0  +
+ + + +++++++ +
+   +     +   +
+ +++++++ + +++
+       +     +
+++++++++++++++
#goal
+++++++++++++++
+C    +       +
+ + +++ +++++ +
+ +   +     + +
+A+++ +++ +++ +
+  0 A    +   +
+++ + +++++ +++
+     +     + +
+ ++   ++++++ +
+   +       + +
+ +++++++++ + +
+         +   +
+ + + +++++++ +
+   +     +   +
+ +++++++ + +++
+       +     +
+++++++++++++++
#end
