#domain
hospital
#levelname
G30
#colors
blue: 0, A, D
#initial
+++++++++++++
+   +       +
+ + + +++ +0+
+ + + + +   +
+ +++ + + + +
+     +   + +
+++  +A + + +
+ +     + + +
+ +++ ++D++ +
+           +
+++++++++++++
#goal
+++++++++++++
+   +       +
+0+ + +++ + +
+ + + + +A  +
+ +++ + + + +
+     +   + +
+++  +  + + +
+ +     + + +
+ +++ ++D++ +
+           +
+++++++++++++
#end
