#domain
hospital
#levelname
G301
#colors
blue: 0, B, E
#initial
+++++++++
+       +
+ ++  + +
+ +     +
+ +B+++++
+0      +
+ +++++ +
+  E    +
+++++++++
#goal
+++++++++
+       +
+ ++  + +
+ +     +
+ + +++++
+       +
+ +++++B+
+   0   +
+++++++++
#end
