#domain
hospital
#levelname
G306
#colors
blue: 0, 1, 2
#initial
+++++++++++++++
+   +         +
+ + +++ + +++ +
+ +   + + +   +
+  ++ +++ +++ +
+ + +   +   + +
+ + +++ +++  ++
+ +   +   +   +
+ +++ +++ +++ +
+ + +   +     +
+ + +++ +++++ +
+   +   + 0   +
+++++ +++ +1+++
+   +     +   +
+ ++2 ++++ ++ +
+             +
+++++++++++++++
#goal
+++++++++++++++
+   +0        +
+ + +++ + +++ +
+ +   + + +   +
+  ++1+++ +++ +
+ + +   +   + +
+ + +++ +++  ++
+ +   +   +   +
+ +++ +++ +++ +
+ + +   +     +
+ + +++ +++++ +
+   +   +     +
+++++ +++ + +++
+   +     +   +
+ ++  ++++ ++ +
+             +
+++++++++++++++
#end
