#domain
hospital
#levelname
G314
#colors
blue: 0, 1, A, C
#initial
+++++++++++
+ +     + +
+ ++A++   +
+ + 1   + +
+ +  ++++ +
+   +     +
+ +++ +++ +
+     + C +
+ + + + +++
+     +   +
+++++++++++
#goal
+++++++++++
+ +   1 + +
+ ++ ++   +
+ +    C+ +
+ +  ++++ +
+   +    A+
+ +++ +++ +
+     +   +
+ + + + +++
+     +   +
+++++++++++
#end
