#domain
hospital
#levelname
G325
#colors
blue: 0, A, C
#initial
+++++++++++++++++++++
+       + A         +
+ + + + + +++++ + + +
+0+ + + + +     C + +
+ +++ + + A  ++ C  A+
+ + +     + + + + + +
+ + + +++++ + + + + +
+ +       + +     + +
+ ++ A++ +C + +++++ +
+           +       +
+++++++++++++++++++++
#goal
+++++++++++++++++++++
+       +           +
+ + + +0+ +++++ + + +
+ + + + + +       + +
+ +++ + +    ++     +
+ + +  C  + + + + + +
+ + + +++++ + + + + +
+ +  A    + +   C + +
+ ++  ++ +C + +++++ +
+         A +       +
+++++++++++++++++++++
#end
