#domain
hospital
#levelname
G327
#colors
blue: 0, A, B
#initial
+++++++++++++++++++++
+       +          B+
+ ++ +A   + +++ + + +
+ +   + + +   + +A  +
+ + + + + +++ + + + +
+ +     +   + +   + +
+ + + +++++ + +++ +++
+ + +  0    + +  A+ +
+ + + + +++++ +++++ +
+ + + +     + +   + +
+ + A +A+++ + +   + +
+   +       +   +   +
+++++++++++++++++++++
#goal
+++++++++++++++++++++
+       +           +
+ ++ +   B+ +++ + + +
+ +A  + + +   + +   +
+ + + + + +++ + + +B+
+ +     +  A+0+   + +
+ + + +++++ + +++ +++
+ + +       + +   + +
+ + + + +++++ +++++ +
+ + + +     + +   + +
+ +   + +++A+ +   + +
+   +  A    +   +   +
+++++++++++++++++++++
#end
