#domain
hospital
#levelname
G332
#colors
blue: 0, A
#initial
+++++++++++
+         +
+++A+ + + +
+       + +
+ +++++ + +
+ +     + +
+ + +++++ +
+ +     +0+
+  +++++A +
+         +
+++++++++++
#goal
+++++++++++
+        0+
+++ + + + +
+A      + +
+ +++++ + +
+ +     + +
+ + +++++ +
+ +     + +
+  +++++  +
+         +
+++++++++++
#end
