#domain
hospital
#levelname
G333
#colors
blue: 0, A
#initial
+++++++++++
+         +
+++++++++ +
+         +
+ +++A+++ +
+ A  0    +
+ A     +++
+   +     +
+++++++++++
#goal
+++++++++++
+         +
+++++++++ +
+         +
+ +++ +++A+
+     A   +
+   A   +++
+  0+     +
+++++++++++
#end
