#domain
hospital
#levelname
G337
#colors
blue: 0, A, B
#initial
+++++++++++
+   +     +
+ + + +++ +
+ + + +   +
+++ + +++ +
+   +   + +
+   +++++ +
+ +  B+   +
+ +++ + 0++
+   + + + +
+ + A++   +
+ +     + +
+ + ++++  +
+         +
+++++++++++
#goal
+++++++++++
+   +     +
+ + + +++ +
+ + + +   +
+++ + +++ +
+   +   + +
+   +++++ +
+ + A +   +
+ +++ +  ++
+   + + + +
+ +  ++   +
+ +     + +
+ + ++++  +
+         +
+++++++++++
#end
