#domain
hospital
#levelname
G34
#colors
blue: 0, A, C
#initial
+++++++++++
+ +       +
+ + +++ +++
+   + +   +
+ + A +++ +
+       + +
+ +++++++ +
+ +       +
+ + +++++++
+ +       +
+ +++0+++ +
+   +     +
+ + + +++++
+  C      +
+++ +++++ +
+ + +     +
+ +++ +++ +
+     +   +
+++++++++++
#goal
+++++++++++
+ +       +
+ + +++ +++
+   + +   +
+ +   +++ +
+       + +
+ +++++++ +
+ +       +
+ + +++++++
+ +    C  +
+ +++ +++ +
+   +  A  +
+ + + +++++
+         +
+++ +++++ +
+ + +     +
+ +++ +++ +
+     +   +
+++++++++++
#end
