#domain
hospital
#levelname
G341
#colors
blue: 0, 1, 2, 3, 4, A, B, E, D
#initial
+++++++++++++++++
+       + B     +
+ +++++ +  +  +++
+   + 2 +   +   +
+ +++ + +++ +++ +
+ +   + + +   + +
+ + +++ + +++   +
+ +   +   +34 + +
+ +++ +++++ +++ +
+   +           +
+++++ +   +++ + +
+   + +   + 0   +
+ +D+++ + A +++ +
+ + E  A    +   +
+ + +++++++++ +++
+ + +E    + 1 + +
+ + + + ++  +++ +
+    B          +
+++++++++++++++++
#goal
+++++++++++++++++
+       +       +
+ +++++ +  +  +++
+ B +  A+   +   +
+ +++ + +++ +++ +
+ +   + + +   + +
+ + +++ + +++   +
+ +   +   +   + +
+ +++ +++++ +++ +
+   +           +
+++++ +   +++ + +
+ 1 +E+   +     +
+ + +++ +   +++ +
+ +         +   +
+ + +++++++++ +++
+ + +  3  +   + +
+ + + + ++  +++ +
+         0     +
+++++++++++++++++
#end
