#domain
hospital
#levelname
G342
#colors
blue: 0, 1, 2
#initial
+++++++++++++++++
+               +
+++ +++++ + +++ +
+   +   +   + + +
+ +++ + + +   + +
+ +   +   +   + +
+ + +++++++ +++++
+ +   +   +     +
+ +0+++ + +++++ +
+ +     + +   + +
+ + +2+++ + 1 + +
+       +   +   +
+++++++++++++++++
#goal
+++++++++++++++++
+               +
+++ +++++ + +++ +
+   +   +   + + +
+ +++ + + +   + +
+ +   +   +   + +
+ + +++++++ +++++
+ +   +   +     +
+ + +++ + +++++ +
+ +     + +   + +
+ + + +++ +   + +
+1      +   +   +
+++++++++++++++++
#end
