#domain
hospital
#levelname
G345
#colors
blue: 0, A, B
#initial
+++++++++++
+    B    +
+ +++ +++++
+ +   +   +
+ + +++ + +
+ +   +   +
+++++ + + +
+     + + +
+  ++++ + +
+ +      0+
+ + ++++A +
+ A +     +
+ +++ + + +
+     + + +
+++++++++++
#goal
+++++++++++
+        A+
+ +++ +++++
+ +   +   +
+ + +++ +B+
+ +   +   +
+++++ + + +
+    A+ + +
+  ++++ + +
+ +       +
+ + ++++  +
+   +     +
+ +++ + + +
+     + + +
+++++++++++
#end
