#domain
hospital
#levelname
G346
#colors
blue: 0, C, D
#initial
+++++++++++
+ +  C    +
+ + +++ +++
+ + + +   +
+ + + +++ +
+   +   + +
+ +++ ++  +
+ +   0 + +
+ +++++ + +
+       + +
+++++++ + +
+       + +
+++++++ + +
+     + + +
++++  +++ +
+   +     +
+ +++ +++ +
+ D       +
+++++++++++
#goal
+++++++++++
+ +     C +
+ + +++ +++
+ + + +   +
+ + + +++ +
+   +   + +
+ +++ ++  +
+ +   D + +
+ +++++ + +
+       + +
+++++++ + +
+       + +
+++++++ + +
+     + + +
++++  +++ +
+   +     +
+ +++ +++ +
+         +
+++++++++++
#end
