#domain
hospital
#levelname
G347
#colors
blue: 0, A, B, C
#initial
+++++++++++++++++++
+ A             C +
+ + +++C++++  +++ +
+ + +       + +   +
+ + +++ +++++ + +++
+   B   +   0 +   +
+  ++ +++ ++ ++ + +
+ +     + +     + +
+ +++ +A  + +C+++ +
+               + +
+++ + + +++++C+ + +
+     +    B+     +
+++++++++++++++++++
#goal
+++++++++++++++++++
+                 +
+ + +++ ++++  +++ +
+ + +       + +   +
+ + +++ +++++ + +++
+       +    C+   +
+ C++ +++ ++ ++ + +
+0+     + +     + +
+ +++ +   + + +++ +
+               + +
+++ + + +++++ + + +
+     + B   +   B +
+++++++++++++++++++
#end
