#domain
hospital
#levelname
G354
#colors
blue: 0, 1, 2, 3, 4, A, B
#initial
+++++++++++
+1    +   +
+ +++2  +++
+   + +   +
+++ + +++ +
+   + +   +
+ +++ + +++
+     +   +
+0 B+++++ +
+   +     +
+++ 3     +
+ +   +A+ +
+ +++++ + +
+   +   + +
+4+ + +++ +
+         +
+++++++++++
#goal
+++++++++++
+     +   +
+ +++   +++
+   + +  2+
+++ + +++ +
+   + +   +
+4+++ + +++
+     +   +
+   +++++ +
+   +     +
+++       +
+ +   + + +
+ +++++ +A+
+   +  0+ +
+ + + +++ +
+        3+
+++++++++++
#end
