#domain
hospital
#levelname
G358
#colors
blue: 0, 1, A, B, E, D
#initial
+++++++++++++++++++
+ +         +     +
+ + +++A+++ + +++ +
+ + +   +   + + + +
+ + + +++ +++ + + +
+ + + +     + B + +
+ + + A++++++++++ +
+  E+   +   +    A+
+ ++++  + + + +++++
+ D     + + 1     +
+ +  + ++ ++  + + +
+ +     0 +     + +
+ +++++A+ + +++ + +
+   +   + +     + +
+++ + + + +++  ++ +
+     +B          +
+++++++++++++++++++
#goal
+++++++++++++++++++
+ +         +     +
+ + +++ +++B+ +++ +
+ + +A  +  B+ + + +
+ + + +++ +++ + + +
+ + + +     +   + +
+ + +  ++++++++++ +
+   +   +   +     +
+ ++++  + + + +++++
+       + +       +
+ +  +D++ ++  + + +
+ +       +     + +
+ +++++ + + +++ + +
+   +   + +     + +
+++1+ + + +++  ++ +
+     +           +
+++++++++++++++++++
#end
