#domain
hospital
#levelname
G365
#colors
blue: 0, 1, A, B, D
#initial
+++++++++++++++
+       +   + +
++++D + +   + +
+   + +A  +  0+
+   + +++++++ +
+     +       +
+ +++++ + +++++
+     + + +   +
+++++ +   +++ +
+   + + +     +
+++ A + + +1+ +
+  B  +     + +
+++++++++++++++
#goal
+++++++++++++++
+ A     +   + +
++++  + +   +0+
+   + +   +   +
+   + +++++++ +
+     +       +
+ +++++D+ +++++
+     + + +   +
+++++ +   +++ +
+   + + +     +
+++   +A+ + + +
+     +    1+ +
+++++++++++++++
#end
