#domain
hospital
#levelname
G366
#colors
blue: 0, A, B
#initial
+++++++++++++++++++
+ +     + +   +   +
+   + + + + + +++ +
+   + +   + +   + +
+ +++ +++++++++ + +
+   + +       + + +
+++ + + +++++ +   +
+   +   +     + + +
+ +++++++ + +++ + +
+ +  B  + + +   + +
+ +++++ + + + +++ +
+       + + +     +
+++++++ + + ++ ++ +
+     + + +   +   +
+ +++ +0+ +++++ +++
+   + + +     +   +
+++ + + +++++ +++ +
+   +       A     +
+++++++++++++++++++
#goal
+++++++++++++++++++
+ +     + +   +   +
+   + + + + + +++0+
+   + +   + +   + +
+ +++ +++++++++ + +
+   + +       + + +
+++ + + +++++ +   +
+   +   +     + + +
+ +++++++ + +++ + +
+ +   A + + +   + +
+ +++++ + + + +++ +
+       + + +     +
+++++++ + + ++ ++ +
+     + + +   +   +
+ +++ + + +++++ +++
+   + + +     +   +
+++ + + +++++ +++ +
+   +             +
+++++++++++++++++++
#end
