#domain
hospital
#levelname
G367
#colors
blue: 0, B
#initial
+++++++++++++++
+     +       +
+ +++ + +++++ +
+   + + +   + +
+++ +B+++   + +
+   +   B + + +
+ +++ +++++ + +
+ +       +   +
+ +++++ +++++ +
+     +     + +
+ +++ +++ + + +
+   + + + +0  +
+ + + + + +++++
+   +   +     +
+++++++++++++++
#goal
+++++++++++++++
+     +       +
+ +++ + +++++ +
+   + + +   + +
+++ + +++   + +
+   +     + + +
+ +++ +++++ + +
+ +B      +   +
+ +++++ +++++ +
+ B   +     + +
+ +++ +++ + + +
+   + + + +   +
+ + + + + +++++
+   +   +     +
+++++++++++++++
#end
