#domain
hospital
#levelname
G368
#colors
blue: 0, A, D
#initial
+++++++++
+   +   +
+ + + + +
+ +   + +
+ +0+++ +
+   A + +
+ +++ + +
+ +   + +
+   +++ +
+ +     +
+ + + + +
+ + +  A+
+ + + +++
+   +D  +
+++++++++
#goal
+++++++++
+   + 0 +
+ + + + +
+ +   + +
+ + +++ +
+     + +
+A+++ + +
+ +   + +
+   +++ +
+ +     +
+ + + + +
+ + +   +
+ + + +++
+   +   +
+++++++++
#end
