#domain
hospital
#levelname
G372
#colors
blue: 0
#initial
+++++++++
+       +
+ + +++ +
+ +  0+ +
+ +++ + +
+ +   + +
++  +++ +
+ + + + +
+ + + + +
+   +   +
+++++++++
#goal
+++++++++
+       +
+ + +++ +
+ +   + +
+ +++ + +
+ +   + +
++  +++ +
+ + + + +
+ + + + +
+   +   +
+++++++++
#end
