#domain
hospital
#levelname
G374
#colors
blue: 0, A
#initial
+++++++++
+       +
+ + +++++
+ + +   +
+ + + +++
+ + +   +
+++ +++ +
+   +   +
+ ++   ++
+A  + + +
+ + + + +
+ + + + +
+ + + + +
+ + + + +
+ + + + +
+ +   + +
+ ++++0 +
+       +
+++++++++
#goal
+++++++++
+      A+
+ + +++++
+ + +   +
+ + + +++
+0+ +   +
+++ +++ +
+   +   +
+ ++   ++
+   + + +
+ + + + +
+ + + + +
+ + + + +
+ + + + +
+ + + + +
+ +   + +
+ ++++  +
+       +
+++++++++
#end
