#domain
hospital
#levelname
G375
#colors
blue: 0, 1, 2, 3
#initial
+++++++++
+ 0     +
+++2+++ +
+   + + +
+  ++ + +
+ +   + +
+ + + + +
+ + +   +
+ + +++ +
+ +   + +
+ 3++   +
+ +   + +
+++  ++ +
+     1 +
+++++++++
#goal
+++++++++
+       +
+++ +++ +
+   + + +
+  ++ + +
+ +   + +
+ + + + +
+ + +   +
+ + +++ +
+ +   + +
+  ++   +
+ +3 1+ +
+++  ++ +
+       +
+++++++++
#end
