#domain
hospital
#levelname
G378
#colors
blue: 0, E
#initial
+++++++++++++++++++++
+         +         +
+++ +++++ + +++++ +++
+   +     + +   +   +
+ +++ +++++ + + +++ +
+ +   +   + + + +   +
+ +++ + + + +++ +++++
+   + + + + +   +   +
+ + + + + + + + + +++
+   +   + +   + +   +
+ + ++E+++++++  + + +
+ +           + + + +
+ 0++++++++++ + +++ +
+ +         +   +   +
+ + +++++++ +++++ + +
+   +             + +
+++++++++++++++++++++
#goal
+++++++++++++++++++++
+     0   +         +
+++ +++++ + +++++ +++
+   +     + +   +   +
+ +++ +++++ + + +++ +
+ +   +   + + + +   +
+ +++ + + + +++ +++++
+   + + +E+ +   +   +
+ + + + + + + + + +++
+   +   + +   + +   +
+ + ++ +++++++  + + +
+ +           + + + +
+  ++++++++++ + +++ +
+ +         +   +   +
+ + +++++++ +++++ + +
+   +             + +
+++++++++++++++++++++
#end
