#domain
hospital
#levelname
G383
#colors
blue: 0, B
#initial
+++++++++
+       +
+ + +++ +
+ B   + +
+ +++ 0++
+       +
+++++++++
#goal
+++++++++
+       +
+B+ +++ +
+     + +
+ +++  ++
+       +
+++++++++
#end
