#domain
hospital
#levelname
G391
#colors
blue: 0, A
#initial
+++++++++
+     + +
+ +++ + +
+ + +   +
+ + +++++
+     + +
+++++ + +
+     + +
+ +++++ +
+ +     +
+ + +++0+
+ +     +
+ +A+ + +
+ + +   +
+ +++ + +
+     + +
+++++++++
#goal
+++++++++
+     + +
+ +++ + +
+ + +  0+
+ + +++++
+ A   + +
+++++ + +
+     + +
+ +++++ +
+ +     +
+ + +++ +
+ +     +
+ + + + +
+ + +   +
+ +++ + +
+     + +
+++++++++
#end
