#domain
hospital
#levelname
G399
#colors
blue: 0, A, B, C
#initial
+++++++++++++++++
+     +         +
+ +++ + +++++++ +
+ + +   +   +   +
+ + +++++ +0+ +++
+ +       + +   +
+ + +C+++ +++++ +
+   +   + A   + +
+   +++ +++ + + +
+ +   + +   +   +
+ +++ +   +++++ +
+ +   + + B   + +
+ +++++ +++ + + +
+           +   +
+++++++++++++++++
#goal
+++++++++++++++++
+  C  +       A +
+ +++ + +++++++ +
+ + +   +   +   +
+ + +++++ + + +++
+ +       + +   +
+ + + +++ +++++ +
+   +   +     + +
+ B +++ +++ + + +
+ +   + +   +   +
+ +++ +   +++++ +
+ +   + +     + +
+ +++++ +++ + + +
+           +0  +
+++++++++++++++++
#end
