#domain
hospital
#levelname
G40
#colors
blue: 0, 1, 2
#initial
+++++++++++
+         +
+ +++++ + +
+     + + +
+++ +++ + +
+   +   + +
+ +++ ++  +
+ + + +   +
+ + + +++++
+   +     +
+++ +++++ +
+ + +  0  +
+ + + +++++
+   +2+   +
+  ++++++ +
+ +       +
+ +1++++  +
+   +     +
+++++++++++
#goal
+++++++++++
+         +
+ +++++ + +
+     + + +
+++ +++ + +
+   +   + +
+ +++ ++ 1+
+ + + +   +
+ + + +++++
+   +    0+
+++ +++++ +
+ + +     +
+ + + +++++
+   + +   +
+  ++++++ +
+ +       +
+ + ++++  +
+   +     +
+++++++++++
#end
