#domain
hospital
#levelname
G400
#colors
blue: 0, A, C
#initial
+++++++++++
+   +     +
+ + + +++ +
+   +   + +
+ +++++ + +
+     + + +
+++++ A +0+
+  C+   + +
+ + +++++ +
+ +     + +
+ +++ + + +
+   + +   +
+++   +++++
+         +
+++++++++++
#goal
+++++++++++
+   +     +
+ + + +++ +
+ 0 +   + +
+ +++++ + +
+   C + + +
+++++   + +
+   +   + +
+ + +++++ +
+ +     + +
+ +++ + + +
+   + +   +
+++   +++++
+         +
+++++++++++
#end
