#domain
hospital
#levelname
G402
#colors
blue: 0, B, C
#initial
+++++++++++
+ C +     +
+ +   + + +
+   +   + +
+ 0 +++++ +
+ +    B  +
+ ++++ ++++
+     + B +
+++++ +++ +
+         +
+++++++++++
#goal
+++++++++++
+   +     +
+ +   +C+ +
+   +   + +
+   +++++ +
+ +   B   +
+ ++++ ++++
+     +   +
+++++ +++ +
+   B     +
+++++++++++
#end
