#domain
hospital
#levelname
G406
#colors
blue: 0, 1, 2, A, B, C, D
#initial
+++++++++++++++
+           + +
+ +++++++++ + +
+           + +
+   + + +  ++ +
+ + + +       +
+++ + +++++++A+
+   +         +
+ +2+ +++++ +++
+   + 1 +     +
++0 B++ +++   +
+ + + +     + +
+ +++ +++D +A +
+ +   +       +
+ + + + +++++++
+ + +   +     +
+ + +++++++ + +
+           + +
+++++++++++++++
#goal
+++++++++++++++
+           + +
+ +++++++++ + +
+           + +
+   +D+ +  ++ +
+ + + +       +
+++ + +++++++ +
+   +A        +
+ + + +++++ +++
+   + 2 +     +
++   ++ +++ B +
+ + + +     + +
+ +++ +++  +  +
+ +   +      C+
+ + + + +++++++
+ + +   +     +
+ + +++++++ + +
+           + +
+++++++++++++++
#end
