#domain
hospital
#levelname
G408
#colors
blue: 0, A
#initial
+++++++++++++++
+     +       +
+ +++ + +++++ +
+ + +   +   + +
+ + +++++++ + +
+ +         + +
+ +++ +  ++++ +
+   + +     + +
+++ + +++++ + +
+   +     + A +
+ +++++++ +++++
+ +     +   + +
+ + +++++++ + +
+ +       +   +
+++0+++ +++ + +
+ + + + +   + +
+ + + + + + + +
+     +   +   +
+++++++++++++++
#goal
+++++++++++++++
+     +       +
+ +++ + +++++ +
+ + +   +   + +
+ + +++++++ + +
+ +         + +
+ +++ +  ++++ +
+   + +     + +
+++ + +++++ + +
+   +     +   +
+ +++++++ +++++
+ +     +   + +
+ + +++++++ + +
+ +       +   +
+++ +++ +++ + +
+ + + + +   + +
+ + + + + + + +
+     +   +   +
+++++++++++++++
#end
