#domain
hospital
#levelname
G41
#colors
blue: 0, A, B, C
#initial
+++++++++
+       +
+++++ + +
+   +   +
+ + +++ +
+ +   + +
+ +++ + +
+   +   +
+ + +++ +
+ +  C+ +
+ 0A+++ +
+ +     +
+ + + +++
+ +   + +
+ +B+ + +
+ +     +
+++++++++
#goal
+++++++++
+      C+
+++++ + +
+   +   +
+ + +++ +
+ +   + +
+ +++ + +
+   +   +
+ + +++ +
+ +  0+ +
+   +++ +
+ +     +
+ + + +++
+ +   + +
+ + + + +
+ +     +
+++++++++
#end
