#domain
hospital
#levelname
G410
#colors
blue: 0, A
#initial
+++++++++
+       +
+ ++  A++
+ + +   +
+ + +++ +
+   0   +
+++++++++
#goal
+++++++++
+ A     +
+ ++0  ++
+ + +   +
+ + +++ +
+       +
+++++++++
#end
