#domain
hospital
#levelname
G413
#colors
blue: 0, A, C, D
#initial
+++++++++++++++++++
+ +       +       +
+ + ++++++++++A + +
+0  +         + + +
+ +++++ + + + + + +
+ +     +   +   + +
+ + + +++++++ + + +
+   C       + A   +
+++++ +++++ + + +++
+   + D   + + +   +
+ +++ + + + + +++ +
+       +         +
+++++++++++++++++++
#goal
+++++++++++++++++++
+ + 0     +       +
+ + ++++++++++  + +
+   +         + + +
+D+++++ + + + + + +
+ +     +   +   + +
+ + + +++++++ + + +
+           +  C  +
+++++ +++++ + + +++
+   +     + + +   +
+ +++ + + + + +++ +
+       +         +
+++++++++++++++++++
#end
