#domain
hospital
#levelname
G417
#colors
blue: 0, 1, 2, A, B
#initial
+++++++++++++++++
+          0A   +
+ + ++++++B ++ ++
+     2   +   + +
+ +++ ++  + + + +
+  1    +   +   +
+++++++++++++++++
#goal
+++++++++++++++++
+       A       +
+ + ++++++  ++ ++
+         +B  + +
+ +++ ++  + + + +
+ 1     +2  +   +
+++++++++++++++++
#end
