#domain
hospital
#levelname
G420
#colors
blue: 0, 1, C
#initial
+++++++++++++++++++++
+         +         +
+++++ +++ + +++++++ +
+  C+   + + +   +   +
+ +++ + +++ + + + + +
+   + + +   + + + 1 +
+++ + + +0+++ + + + +
+   + +   +       + +
+ +++ +++++ +++++++ +
+ +   +   + +       +
+ +++++ + + + +++++++
+       +     +     +
+++++++++++++   +++ +
+               +   +
+++++++++++++++++++++
#goal
+++++++++++++++++++++
+         +    1    +
+++++ +++ + +++++++ +
+   +   + + +   +   +
+ +++ + +++ + + + + +
+   + + +   + + +   +
+++ + + + +++ + + + +
+   + +   +       + +
+ +++ +++++ +++++++ +
+ +0  +   + +       +
+ +++++ + + + +++++++
+       +     +     +
+++++++++++++   +++ +
+          C    +   +
+++++++++++++++++++++
#end
