#domain
hospital
#levelname
G422
#colors
blue: 0, A
#initial
+++++++++
+ 0   + +
+ +++ + +
+ +     +
+ + +++ +
+ A   + +
+ +++ + +
+   + + +
+++ + +++
+   +   +
+ +++++ +
+       +
+++++++++
#goal
+++++++++
+     + +
+ +++ + +
+ +     +
+ + +++ +
+     + +
+ +++ + +
+   + + +
+++ + +++
+   +A  +
+ +++++ +
+       +
+++++++++
#end
