#domain
hospital
#levelname
G429
#colors
blue: 0, 1, 2, 3, 4, 5, 6, B, E, C
#initial
+++++++++++++++
+   +       2 +
+++ + + + + + +
+       +  0+ +
+   B++ 51+   +
+     +B6 +   +
++++  + +++ +++
+     + 4 E   +
+  ++++ + +++ +
+       +     +
+ +++ + + B++ +
+   +  B   3  +
+++++++++++++++
#goal
+++++++++++++++
+   +         +
+++ + + +5+0+ +
+23     +   + +
+    ++  B+   +
+     +   +   +
++++  + +++ +++
+  6  +    E  +
+  ++++B+ +++ +
+      1+     +
+ +++ + +4 ++ +
+   +     B   +
+++++++++++++++
#end
