#domain
hospital
#levelname
G431
#colors
blue: 0, 1, 2, 3, 4, A, B, C
#initial
+++++++++++++++++
+  2+         + +
+ + + +  ++++ + +
+ + +    3+   + +
+ + + + +1+ + + +
+ +     + +     +
++C++++++ +0+++ +
+ +       +   + +
+ +  ++++ + +   +
+   +     + + + +
+ + + ++++4 +C+ +
+ + +     + + + +
+ + +B+++ + + + +
+          A+   +
+++++++++++++++++
#goal
+++++++++++++++++
+  4+         + +
+ +1+ +  ++++ + +
+ + + 3   +   + +
+ + + + + + + + +
+ +     + + C   +
++ ++++++ + +++ +
+ +       +   + +
+ +  ++++ + +  C+
+   +     + + + +
+ + + ++++  +B+ +
+ + +     + + + +
+ + + +++ + + + +
+           +   +
+++++++++++++++++
#end
