#domain
hospital
#levelname
G432
#colors
blue: 0, 1, A, D
#initial
+++++++++++
+     +   +
+D+++ A++ +
+   +   + +
++ + ++ + +
+ + 0   + +
+ + ++ ++ +
+   +     +
+ +++  ++ +
+     +1  +
+++++++++++
#goal
+++++++++++
+     +   +
+ +++  ++ +
+  1+   + +
++ +0++ + +
+ +     + +
+ + ++ ++ +
+   +     +
+ +++  ++ +
+     +   +
+++++++++++
#end
