#domain
hospital
#levelname
G445
#colors
blue: 0, 1, A
#initial
+++++++++++
+   +     +
+ + + +++ +
+ +       +
+ ++++ ++ +
+ +       +
+ + A+++ ++
+ + +  1  +
+ +++ +++ +
+     + + +
+ +++++   +
+       + +
+++ +++++ +
+   +     +
+ +++ +++++
+ +   +   +
+  A+++++ +
+    0+  A+
++++  + + +
+  A    + +
+++++++++++
#goal
+++++++++++
+   +     +
+ + + +++ +
+ +       +
+ ++++ ++ +
+ +       +
+ +A +++ ++
+ + +     +
+ +++ +++ +
+1    + + +
+ +++++   +
+       + +
+++ +++++ +
+   +  0  +
+ +++ +++++
+ +   +  A+
+   +++++ +
+     +   +
++++  + + +
+       + +
+++++++++++
#end
