#domain
hospital
#levelname
G446
#colors
blue: 0, A, B, C
#initial
+++++++++++++++++++
+         +       +
+ + ++ ++ +++++ + +
+ + +C  +     + + +
+ +++ + +++++ +++ +
+   + +   +   +   +
+++ + +++ + +++ + +
+ +     + +     + +
+ +++++++ +++++++ +
+ +     +       + +
+ + +++ +++ + +++ +
+ + +       +   + +
+ + + + +++ +++ + +
+ +       + + +   +
+ +++++++ +++ + +++
+   +   +A   0+ B +
+ + + + +++++++ + +
+ +   +           +
+++++++++++++++++++
#goal
+++++++++++++++++++
+A  B     +       +
+ + ++ ++ +++++ + +
+ + +   +     + + +
+ +++ + +++++ +++ +
+   + +   +   +   +
+++ + +++ + +++ + +
+ +     + +     + +
+ +++++++ +++++++ +
+ +     +       + +
+ + +++ +++ + +++ +
+ + +       +   + +
+ + + + +++ +++ + +
+ +       + + +   +
+ +++++++ +++ + +++
+   +   +     + 0 +
+ + + + +++++++ + +
+ +   +           +
+++++++++++++++++++
#end
