#domain
hospital
#levelname
G450
#colors
blue: 0, 1, 2, A, B, D
#initial
+++++++++++
+     D   +
+  ++++   +
+       + +
+  ++++++ +
+ + +     +
+ 2 + +++ +
+ 0     + +
+A  1 + + +
+     + + +
+++++++++++
#goal
+++++++++++
+         +
+ A++++   +
+       + +
+  ++++++ +
+ + +     +
+ D + +++ +
+       + +
+     + + +
+   B + + +
+++++++++++
#end
