#domain
hospital
#levelname
G451
#colors
blue: 0, 1, A, B, C, D
#initial
+++++++++++++++++++++
+   +           A   +
+ +++ + +++++A+ +++ +
+     + +         + +
+ + +D+ + + + +++++ +
+ B +   + +   +  1  +
+++++ +++ 0++ + +++++
+   +  C+   + +     +
+ + +++ +++ +++++++ +
+A+   +   +       + +
+ +++ + + + + ++ ++ +
+ +   + +   +       +
+ + +++++ +++++ + +++
+   +     +     + + +
+ +++++  ++ +++++ + +
+       +           +
+++++++++++++++++++++
#goal
+++++++++++++++++++++
+  C+               +
+ +++ + +++++ + +++ +
+     + +D        + +
+ + + + + + + +++++ +
+   +   + +   +   B +
+++++ +++  ++ + +++++
+   +   +   + +     +
+ + +++ +++ +++++++ +
+ +   +   +       + +
+ +++ + + + + ++ ++ +
+ +   + +   +       +
+ + +++++ +++++ + +++
+   +     +     + + +
+ +++++  ++ +++++ + +
+       +  1        +
+++++++++++++++++++++
#end
