#domain
hospital
#levelname
G453
#colors
blue: 0, A, B, E
#initial
+++++++++++++++
+       +     +
+ + + +   +++ +
+ + +     +   +
+ A +++++ + 0 +
+           + +
+AB++++++E+ + +
+       + + A +
+ +++  ++ + +++
+ +   +   +   +
+ +A++  +++++++
+ +           +
+++++++++++++++
#goal
+++++++++++++++
+ E     +    A+
+ + + +   +++ +
+ + +A    +  B+
+   +++++ +   +
+           + +
+  ++++++ + + +
+       + +   +
+ +++  ++ +A+++
+0+   +   +A  +
+ + ++  +++++++
+ +           +
+++++++++++++++
#end
