#domain
hospital
#levelname
G459
#colors
blue: 0, A, B
#initial
+++++++++++
+         +
+++++ +++ +
+   + +   +
+ +++ +++++
+ +       +
+ ++++++  +
+   A     +
+ + +++++++
+ +       +
+ +++++++ +
+         +
+++++ + +0+
+B      + +
+++++++++++
#goal
+++++++++++
+         +
+++++ +++ +
+   + +   +
+ +++ +++++
+ +       +
+ ++++++  +
+         +
+ + +++++++
+A+      0+
+ +++++++ +
+         +
+++++ + + +
+       + +
+++++++++++
#end
