#domain
hospital
#levelname
G460
#colors
blue: 0, 1, A
#initial
+++++++++
+       +
+++++++ +
+     + +
+ A++++ +
+   +   +
+++ + 1++
+   +   +
+  ++++ +
+     + +
+++++ + +
+   +   +
+   +++ +
+0      +
+++++++++
#goal
+++++++++
+       +
+++++++ +
+     + +
+  ++++ +
+   + 1 +
+++ +  ++
+   +   +
+  ++++ +
+     + +
+++++ + +
+ 0 +   +
+   +++ +
+    A  +
+++++++++
#end
