#domain
hospital
#levelname
G461
#colors
blue: 0, 1, 2, 3, 4, 5, 6, 7, A, B, C
#initial
+++++++++++++++++++
+    B 6          +
+ 53+A++    ++1 + +
+ +   +       + 4 +
+ + ++  B + +   + +
+ +           +2  +
+ ++++B+++ ++ + +++
+0+    A+     C   +
+  ++ 7 ++C ++++  +
+         +       +
+++++++++++++++++++
#goal
+++++++++++++++++++
+                 +
+   + ++    ++  + +
+ +   + A 1  B+  6+
+ + ++    + +   +2+
+ +C B       B+   +
+ ++++ +++ ++ + +++
+ +     +     0   +
+  ++   ++  ++++  +
+  B    A +     7 +
+++++++++++++++++++
#end
