#domain
hospital
#levelname
G466
#colors
blue: 0, 1, B
#initial
+++++++++++++++
+     +   +   +
+ +++ + + + + +
+   +   +   0 +
+++ +++ + +++ +
+  B  + 1 +   +
+ +++ +++++ + +
+ + +       + +
+ + + +++ + + +
+   +    B  + +
+++++++++++++++
#goal
+++++++++++++++
+     +   +   +
+ +++ + + + + +
+   +   +    B+
+++ +++ + +++ +
+     +   +   +
+ +++ +++++ + +
+ + + 0  B  + +
+ + + +++ + + +
+   +       + +
+++++++++++++++
#end
