#domain
hospital
#levelname
G469
#colors
blue: 0, B, C
#initial
+++++++++
+ +     +
+ + +   +
+ +     +
+0+++ +++
+ +   + +
+ + +++ +
+ + +   +
+ + + C +
+   B + +
+++++++++
#goal
+++++++++
+ +     +
+ + +   +
+ +     +
+ +++ +++
+C+   + +
+ + +++ +
+ + +   +
+ + +   +
+     +0+
+++++++++
#end
