#domain
hospital
#levelname
G473
#colors
blue: 0, B
#initial
+++++++++++++++++++
+                 +
+ +++ + + +++++ + +
+B+   + + +       +
+ + +++++ + +++++ +
+ +   +   +   + + +
+ +++ + +++++ + + +
+   +     +   +   +
+++++++++ + +++ +++
+       + + +   + +
++0++++ +++ + +++ +
+     + +   + +   +
+ + +++ + +++ + + +
+ +       +     + +
+++++++++++++++++++
#goal
+++++++++++++++++++
+                 +
+ +++ + + +++++ + +
+ +   + + +       +
+ + +++++ + +++++ +
+ +   +   +   + + +
+ +++ + +++++ + + +
+   +     +   +   +
+++++++++ + +++ +++
+       + + +   + +
++ ++++ +++ + +++ +
+     + +   + +   +
+ + +++ + +++ + + +
+ +       +  0  + +
+++++++++++++++++++
#end
