#domain
hospital
#levelname
G476
#colors
blue: 0, 1, 2, 3, 4, A, B, C, D
#initial
+++++++++++++++
+     +       +
+   +  ++ + + +
+ + +     +  3+
+++B+++++++++ +
+   +     +   +
+ +++++ + + + +
+ 4   + +     +
+ A++ ++++++  +
+ 0   +   1   +
+++  ++ + + +++
+C  + + + +   +
+ + + + + +  ++
+ + +   +     +
+ ++ ++++++2+ +
+        D    +
+++++++++++++++
#goal
+++++++++++++++
+     +       +
+   +  ++ + + +
+ + +     +   +
+++ +++++++++ +
+   +     +   +
+ +++++ + + + +
+     + + 0   +
+  ++ ++++++  +
+     +  C    +
+++  ++ + + +++
+   + + + +   +
+4+ + + + +  ++
+ + +   +     +
+ ++ ++++++ + +
+           1 +
+++++++++++++++
#end
