#domain
hospital
#levelname
G480
#colors
blue: 0, A, C
#initial
+++++++++++++++++++++
+    C+ +   +       +
+ +++ + + + + +++++ +
+   + + + +  0  +   +
+ + + + + +A+++ + + +
+ + +   + +     + + +
+ + +++ + + +++ + + +
+ +       +   + + + +
+ +++ +++++++ + + + +
+ +   + +     +   + +
+ + + + + + +++++++ +
+ + +   + + +     + +
+ + +++ + +++ +++++ +
+   +   +     +     +
+++++++++++++++++++++
#goal
+++++++++++++++++++++
+     + +   +       +
+ +++ + + + + +++++ +
+   + + + +     +   +
+ + + + + + +++ + + +
+ +0+   +C+     + + +
+ + +++ + + +++ + + +
+ +       +   + + + +
+ +++ +++++++ + + + +
+ +   + +     +   + +
+A+ + + + + +++++++ +
+ + +   + + +     + +
+ + +++ + +++ +++++ +
+   +   +     +     +
+++++++++++++++++++++
#end
