#domain
hospital
#levelname
G484
#colors
blue: 0, A, B
#initial
+++++++++++++++++++++
+       B  A  + 0 + +
+   + + +++++ + +   +
+ +   + +       + + +
+   + +++ + ++A++ + +
+   +     +     B  B+
+++++++++++++++++++++
#goal
+++++++++++++++++++++
+ A           +   + +
+   +0+ +++++ + +   +
+ +A  + +B      + + +
+   + +++ + ++B++ + +
+   +     +         +
+++++++++++++++++++++
#end
