#domain
hospital
#levelname
G485
#colors
blue: 0, A, C
#initial
+++++++++++++
+           +
++++  +++++ +
+ A +     + +
+ +++++++++ +
+       +   +
+++++++ + +++
+ C   + +   +
+++ + + +++ +
+   + + +   +
+ +++++ + + +
+       + + +
+ ++ ++++ + +
+ +       + +
+ +++ +++++ +
+     +   + +
+++++++ + + +
+ +   + +   +
+ + +0+  ++++
+   +       +
+++++++++++++
#goal
+++++++++++++
+      0    +
++++  +++++ +
+   +     + +
+ +++++++++ +
+       +   +
+++++++ + +++
+     + +   +
+++ + + +++ +
+   + + +   +
+ +++++ + + +
+A      + + +
+ ++ ++++ + +
+ +       + +
+ +++ +++++ +
+     +   + +
+++++++ + + +
+ +   + +   +
+ + + +  ++++
+   +       +
+++++++++++++
#end
