#domain
hospital
#levelname
G487
#colors
blue: 0, C, D
#initial
+++++++++++
+C+   +   +
+ + + +D+ +
+       + +
+   +++++ +
+   +     +
+++++ +++++
+     + 0 +
+ +++++ + +
+     + + +
+ +++ + + +
+   +   + +
+++++++++++
#goal
+++++++++++
+ +   +   +
+ + + + + +
+       + +
+   +++++ +
+ 0 +     +
+++++ +++++
+     +   +
+ +++++ + +
+     + + +
+D+++ + + +
+   +   + +
+++++++++++
#end
