#domain
hospital
#levelname
G489
#colors
blue: 0, B
#initial
+++++++++++++
+ +     +   +
+ + + B + + +
+ + +   +   +
+ +0+++++ + +
+         + +
+++++++++++++
#goal
+++++++++++++
+ +0    +   +
+ + +   + + +
+ + +   +   +
+ + +++++ + +
+         + +
+++++++++++++
#end
