#domain
hospital
#levelname
G499
#colors
blue: 0, 1, A, B
#initial
+++++++++++
+     +   +
+++ + + + +
+ +   1   +
+A+ + +++ +
+ + +     +
+ + B++ + +
+       0 +
+++++++++++
#goal
+++++++++++
+     +   +
+++ + + + +
+ +    0  +
+ + + +++ +
+ + +     +
+ +  ++ + +
+         +
+++++++++++
#end
