#domain
hospital
#levelname
G6
#colors
blue: 0, B, C
#initial
+++++++++++++++++++++
+             +     +
+++++++++ 0++++ +++ +
+       +   +     + +
+ +++++ +++ + +++   +
+ +   +     + +   + +
+ +++ +++++ + +++ +++
+   +       +   +   +
+ + + +++++++++ + + +
+ + +   +       + + +
+ + +++++ +++++++ +++
+ +     +     + +   +
+ +++++ +++++ + + + +
+ +   +   +   +B+ + +
+ +   +++ +C+++ + + +
+   +   + + +     + +
+++ +++++ + +++++++ +
+ + +     +   +   + +
+ + + +++++++ + + + +
+   +           +   +
+++++++++++++++++++++
#goal
+++++++++++++++++++++
+        B    +     +
+++++++++  ++++ +++ +
+       +   +     + +
+ +++++ +++ + +++   +
+ +   +     + + C + +
+ +++ +++++ + +++ +++
+   +       +   +   +
+ + + +++++++++ + + +
+ + +   +       + + +
+ + +++++ +++++++ +++
+ +     +     + +   +
+ +++++ +++++ + + + +
+ +   +   +   + + + +
+ +   +++ + +++ + + +
+   +   + + +     + +
+++ +++++ + +++++++ +
+ + +     +   +   + +
+ + + +++++++ + + + +
+   +           +   +
+++++++++++++++++++++
#end
