#domain
hospital
#levelname
G62
#colors
blue: 0, 1, 2
#initial
+++++++++++++
+   +    0  +
+++ + ++ ++ +
+   +   +   +
+ +++++ + +++
+   +   +   +
+ + +++++++ +
+ +     +   +
+ +++  ++ +++
+ + +   + + +
+ +  ++ + + +
+    12     +
+++++++++++++
#goal
+++++++++++++
+ 1 +       +
+++ +2++ ++ +
+   +   +   +
+ +++++ + +++
+   +   +   +
+ + +++++++ +
+ +     +   +
+ +++  ++ +++
+ + +   + + +
+ +  ++ + + +
+           +
+++++++++++++
#end
