#domain
hospital
#levelname
G68
#colors
blue: 0, 1, 2, 3, A, B, E, C
#initial
+++++++++++++
+ +         +
+ + + + ++  +
+   +   +   +
+ +++ E++  ++
+     +  1+ +
++  +++ +++ +
+   +   +   +
+ +++3+ +++ +
+           +
+   + +++++ +
+   + +   + +
+++++ +C+ +++
+       +   +
+ +2+ +A+++ +
+     +B    +
+ +++++ +++++
+         0 +
+++++++++++++
#goal
+++++++++++++
+ +         +
+ + + + ++  +
+   +   +   +
+ +++  ++  ++
+     +   + +
++  +++2+++ +
+   +   +   +
+ +++ + +++ +
+           +
+ B + +++++ +
+   + +   + +
+++++ + + +++
+    0  +1  +
+ + + + +++ +
+     +     +
+ +++++ +++++
+         A +
+++++++++++++
#end
