#domain
hospital
#levelname
G70
#colors
blue: 0, A, B, E
#initial
+++++++++++++++++
+   A     +     +
+   B++ +++ + + +
+ A +   + 0 +E+ +
+ + + ++  +++ +++
+ + +   + + +   +
+++ +++++ + +++ +
+   +   +   +   +
+ +++ + +++ + +++
+ A   +     +   +
+ + +++ +++++++++
+ +             +
+ + + ++ ++++ +++
+ +     +   +   +
+ +++++++ + +++ +
+         +     +
+++++++++++++++++
#goal
+++++++++++++++++
+         +     +
+    ++ +++ + + +
+   +   +  B+ + +
+ + + ++  +++ +++
+ + +   + + +   +
+++ +++++ + +++ +
+   +   +   +   +
+ +++ + +++ + +++
+     +     +   +
+ + +++ +++++++++
+ +             +
+ + + ++ ++++ +++
+ +     +   +   +
+ +++++++ + +++ +
+         +     +
+++++++++++++++++
#end
