#domain
hospital
#levelname
G71
#colors
blue: 0, 1, 2, 3, 4, A, C, D
#initial
+++++++++++++++++
+   +   +A      +
+ + + + + +++++ +
+ + +   +     + +
+ + + + +++++ + +
+ +           + +
+ +++ ++D +++++ +
+ +   + +D3     +
+A+++ + + + A++++
+   +   + +   + +
+++ +   + +++ + +
+     +   +     +
+ ++  +++++ +++ +
+   +0  +   +   +
+ + + +++  ++ + +
+ + 4 +   +   C +
+++ + 2 +++++ + +
+   + + +     + +
+ +  ++ +++ ++1 +
+           +   +
+++++++++++++++++
#goal
+++++++++++++++++
+   +   +  4    +
+ + + + + +++++ +
+ + +   +     + +
+ + +A+ +++++ + +
+ +       1   +D+
+ +++ ++  +++++ +
+ +   + +       +
+ +++ +A+ +  ++++
+   +   + +   + +
+++ +   + +++ + +
+     +   +     +
+0++  +++++ +++ +
+   +   +   +   +
+ + + +++  ++ + +
+3+   +   +   2 +
+++ +   +++++ + +
+   + + +     + +
+ +  ++ +++ ++  +
+       D   +   +
+++++++++++++++++
#end
