#domain
hospital
#levelname
G78
#colors
blue: 0, 1, 2, 3, 4, 5, D
#initial
+++++++++
+       +
++++ ++ +
+    35D+
+ +  ++ +
+   +  4+
+++ + + +
+   12+ +
+     + +
+       +
+++++++++
#goal
+++++++++
+       +
++++ ++ +
+     5 +
+ + 1++ +
+ D +   +
+++ + + +
+   3 + +
+     + +
+ 4    0+
+++++++++
#end
