#domain
hospital
#levelname
G80
#colors
blue: 0, B, C
#initial
+++++++++++
+         +
+ ++++B++++
+         +
+ +++++++ +
+       + +
+++++++ + +
+ +       +
+ + +++ + +
+ +     + +
+ + +++++ +
+   +   + +
+ +++++   +
+     +0+ +
+ +++ + + +
+     +B+ +
+++++ +   +
+ C   B   +
+++++++++++
#goal
+++++++++++
+         +
+ ++++ ++++
+      0B +
+ +++++++ +
+       + +
+++++++ + +
+ +       +
+ + +++ + +
+ +     + +
+ + +++++ +
+   +   + +
+ +++++   +
+  B  + + +
+ +++ + +C+
+     + + +
+++++ +   +
+         +
+++++++++++
#end
