#domain
hospital
#levelname
G81
#colors
blue: 0, 1, 2, 3, 4, 5
#initial
+++++++++++
+3+   +   +
+ + + +++ +
+   +     +
+  ++++  4+
+   +     +
++5  +++  +
+   2  1  +
+++++++++++
#goal
+++++++++++
+ +   +0  +
+ + + +++ +
+ 5 +     +
+1 ++++ 3 +
+ 4 +     +
++   +++  +
+         +
+++++++++++
#end
