#domain
hospital
#levelname
G85
#colors
blue: 0, 1, 2, 3, C
#initial
+++++++++++++++
+         +   +
+ +++++ + + +++
+ +   + + + + +
+ + +   + + + +
+3+ +   + + + +
+ + C++ +++ + +
+ +1  +0+   + +
+ +++ + +  +  +
+ + +   +  2  +
+ + +++ ++ ++ +
+     +       +
+++++++++++++++
#goal
+++++++++++++++
+         +   +
+ +++++ + + +++
+ +   + + +0+ +
+ + +   + + + +
+ + +   + + + +
+ +  ++ +++ + +
+ +   + +   + +
+ +++ + +  +  +
+ + +   +     +
+ + +++ ++ ++ +
+     +       +
+++++++++++++++
#end
