#domain
hospital
#levelname
G87
#colors
blue: 0
#initial
+++++++++++
+   +     +
+ + +++++ +
+ +     + +
+ +++++ + +
+ +     + +
+ +++ +++ +
+   +   + +
+0+ +++ + +
+   + + + +
+ +++ + + +
+ +   + + +
+ + +++ + +
+ +     + +
+  ++++ + +
+     +   +
+++++++++++
#goal
+++++++++++
+   +     +
+ + +++++ +
+ +     + +
+ +++++ + +
+ +     + +
+ +++ +++ +
+   +   + +
+ + +++ + +
+   + + + +
+ +++ + + +
+ +   + + +
+ + +++ + +
+ +     + +
+  ++++ + +
+     +   +
+++++++++++
#end
