#domain
hospital
#levelname
G9
#colors
blue: 0, 1, 2, 3, 4, B, C
#initial
+++++++++++
+   +     +
+ + + +++ +
+         +
+ +++  ++ +
+ +   +   +
+  C+ +++ +
+4+ +     +
+2+   B++++
+   3    B+
+++   +++ +
+ + +1+  0+
+ + +++ + +
+       +B+
+++++++++++
#goal
+++++++++++
+   +     +
+ + + +++ +
+        B+
+ +++  ++C+
+ +   + 2 +
+   +0+++ +
+ + +     +
+ +B   ++++
+         +
+++   +++ +
+ + + +   +
+ + +++ + +
+       + +
+++++++++++
#end
