#domain
hospital
#levelname
G90
#colors
blue: 0, A, B
#initial
+++++++++++++
+   +       +
+ +++ + +++ +
+ +   +   + +
+ +  + ++ +++
+ +A+   +   +
+ + +B  +++ +
+     + + + +
+ +++ +++ + +
+ +     +   +
+ + +++ +++++
+ +   +     +
+ + +++ +B+ +
+ + +     + +
+ A + +++++ +
+   0 B     +
+++++++++++++
#goal
+++++++++++++
+   +       +
+ +++ + +++ +
+ + B +   + +
+ +  + ++ +++
+ + +   +   +
+ + +   +++ +
+     + + + +
+ +++ +++ + +
+ +     +   +
+ + +++ +++++
+ +   +B    +
+0+ +++ + + +
+ + +     + +
+   + +++++ +
+          A+
+++++++++++++
#end
