#domain
hospital
#levelname
G94
#colors
blue: 0, A, F, E, D
#initial
+++++++++++++++++
+         + A   +
+ + + + + + 0++ +
+   +       + + +
+ +F+ + ++++D   +
+   + + AE     D+
+++++ + + +++++ +
+     + +       +
+++++++++++++++++
#goal
+++++++++++++++++
+     F   +     +
+E+ + + + +  ++ +
+   +       + + +
+D+ + + ++++AD  +
+   + +         +
+++++ + + +++++ +
+     + +       +
+++++++++++++++++
#end
