#domain
hospital
#levelname
G95
#colors
blue: 0, 1
#initial
+++++++++++++
+   +     + +
+ + + +++ + +
+ + +   +   +
+ + +++ +++ +
+ +   + + + +
+ + +   + + +
+ +     +   +
+ +++++++ 0++
+     +     +
+ +++ +++1+ +
+   +     + +
+++++++++++++
#goal
+++++++++++++
+   +     + +
+ + + +++ + +
+ + +   +   +
+ + +++ +++ +
+ +   + + + +
+ + +   + + +
+ +     +   +
+ +++++++  ++
+     +     +
+ +++ +++ + +
+   +     + +
+++++++++++++
#end
