#domain
hospital
#levelname
G99
#colors
blue: 0, A
#initial
+++++++++++++++++
+    A+         +
+ +++++ + +++++ +
+       +   +   +
+ +++++ +++ +++ +
+   +     +   + +
+++ + +++++++ +++
+ + + +     +   +
+ + + + +++ + + +
+ + + +   +    A+
+ + + +++ +++++++
+   +   + +     +
+ +++++ + + +++ +
+     + +   +   +
+++++ + +++ + +++
+   + +   +0  + +
+  ++ + + +++A+ +
+       +       +
+++++++++++++++++
#goal
+++++++++++++++++
+     +         +
+ +++++ + +++++ +
+       +   +   +
+ +++++ +++ +++ +
+   +     +   + +
+++ + +++++++ +++
+ + + +     +   +
+ + + + +++ + + +
+ + + +   +0    +
+ + + +++ +++++++
+   +   + +     +
+ +++++ + + +++ +
+     + +   +   +
+++++ + +++ + +++
+ A + +   +   + +
+  ++ + + +++ + +
+       +       +
+++++++++++++++++
#end
