#domain
hospital
#levelname
MA_Blocking
#colors
red: 0
blue: 1
cyan: 2
pink: 3
grey: 4
green: 5
brown: 6
purple:7
orange: 8
lightblue: 9
#initial
++++++++++++++++++++++++++++++++++++++++++++++++++
+0                                           1   +
+                                                +
+                                                +
+                                                +
+                                                +
+            2                   3               +
+                                                +
+                                                +
+                                                +
+                                                +
+                                                +
+                                                +
+                                                +
+                                                +
+                                                +
+                                                +
+                                                +
+                                                +
+                                                +
+                                                +
+ 4                                              +
+                                                +
+                                                +
+                                                +
+                                                +
+                                                +
+                                    5           +
+                                                +
+                                                +
+                                                +
+                                                +
+                                                +
+                                                +
+      6                                         +
+                                                +
+                                                +
+                                                +
+                                                +
+                                                +
+                                                +
+                                                +
+                               7                +
+                                                +
+                                                +
+                                                +
+    8                                           +
+                                                +
+                                                +
+                                            9   +
++++++++++++++++++++++++++++++++++++++++++++++++++
#goal
++++++++++++++++++++++++++++++++++++++++++++++++++
+                                                +
+                                                +
+                                                +
+                    6                           +
+                                                +
+                           3                    +
+                                                +
+                                                +
+                                                +
+        9                                       +
+                                                +
+                                                +
+                                                +
+                                                +
+                   7                            +
+                                                +
+                                                +
+                                                +
+                                                +
+                                                +
+                                                +
+                                                +
+               8                                +
+                                                +
+                                                +
+                                                +
+                                                +
+                                                +
+                                                +
+ 2                                              +
+                                                +
+                                                +
+                                                +
+                                                +
+                                                +
+    1                     0                     +
+                                                +
+                                                +
+                                                +
+                                                +
+                                                +
+                                                +
+         5                                      +
+                                                +
+                                                +
+                                                +
+                           4                    +
+                                                +
+                                                +
++++++++++++++++++++++++++++++++++++++++++++++++++
#end
