#domain
hospital
#levelname
G0
#colors
blue: 0, C
#initial
+++++++++++++++++
+   +           +
+ + +++++++ +++++
+ + +    C+     +
+ + + + + +++++ +
+ + 0 +       + +
+ +++ +++++++ + +
+ +     +   + + +
+ + +++ + +++ + +
+ + + + +   +   +
+ +++ + + + +++ +
+       + +     +
+++++++++++++++++
#goal
+++++++++++++++++
+   +           +
+ + +++++++C+++++
+ + +     +     +
+ + + + + +++++ +
+ +   +       + +
+ +++ +++++++ + +
+ +     +   + + +
+ + +++ + +++ + +
+ + + + +   +   +
+ +++ + + + +++ +
+       + +     +
+++++++++++++++++
#end
