#domain
hospital
#levelname
G1
#colors
blue: 0, A, D
#initial
+++++++++
+   +   +
+ + + +++
+A+     +
+ +++++ +
+     + +
++D++ + +
+   +   +
+ +++++ +
+ +   + +
+ + + + +
+   + + +
+ +   + +
+ + +  0+
+ + +++++
+   +   +
+++ +++ +
+       +
+++++++++
#goal
+++++++++
+   +  D+
+ + + +++
+ +     +
+ +++++ +
+     + +
++ ++ + +
+   +   +
+ +++++ +
+ +  0+ +
+ + + + +
+   + + +
+ +   + +
+ + + A +
+ + +++++
+   +   +
+++ +++ +
+       +
+++++++++
#end
