#domain
hospital
#levelname
G10
#colors
blue: 0, 1, 2, 3, A, C
#initial
+++++++++++++++++++++
+           +      2+
+ ++++++A++ +A ++++ +
+ + 0       +   +   +
+ + + +++++ +++++   +
+   +   +   +     + +
++  +++ +++ + +++++ +
+ +   + +     + C   +
+ + 3++ + +++++ + +++
+       + +   + +   +
+ +++ +++ + + +++++ +
+   +   + + +       +
+++ +++ +   ++ ++ + +
+ + + +  A+         +
+ + + +++++++++ +++ +
+ +       +   +   + +
+ +++++++ + + +++ + +
+1          +     + +
+++++++++++++++++++++
#goal
+++++++++++++++++++++
+           +       +
+ ++++++ ++ +  ++++ +
+ +      1  +   +   +
+ + + +++++ +++++   +
+   +   +   +   A + +
++2 +++ +++ + +++++A+
+ +   + +     +     +
+ +0 ++ + +++++ + +++
+       + +   + +   +
+ +++ +++C+ + +++++ +
+   +   + + +       +
+++ +++ +   ++ ++ +C+
+ + + +   +         +
+ + + +++++++++ +++ +
+ +       +   +   + +
+ +++++++ + + +++ + +
+        3  +     + +
+++++++++++++++++++++
#end
