#domain
hospital
#levelname
G103
#colors
blue: 0, A, B, C, D
#initial
+++++++++++++++++++
+     +       +   +
+ +++ + + +++ + + +
+A+     D   +   + +
+ +++++++B+++++ + +
+       + +     + +
+ +++++   + + +++ +
+ +   +A0 +   +   +
+   +   + + +  ++ +
+ + + + B   +     +
+ + + + + + +C+++ +
+   + + + +       +
+B+++ + +++++ +++++
+     +     +     +
+++++++++++++++++++
#goal
+++++++++++++++++++
+   0 +       +   +
+ +++ +B+ +++ + + +
+ +         +   + +
+ +++++++ +++++ + +
+       + +     +A+
+ +++++   + + +++ +
+ +   +   +   +   +
+   +   + + +  ++ +
+ + + +     +     +
+ + + + + + + +++ +
+   + + + +       +
+ +++ + +++++ +++++
+     +     +B    +
+++++++++++++++++++
#end
