#domain
hospital
#levelname
G104
#colors
blue: 0, B
#initial
+++++++++++
+   +     +
+ + +++++ +
+ +       +
+ +++++++ +
+     +   +
+ +++ +B+ +
+   + +   +
+++ + + +++
+   + +0+ +
+++++ + + +
+   + + + +
+ +   + + +
+ +   +   +
+++++++++ +
+         +
+++++++++++
#goal
+++++++++++
+   +     +
+ + +++++ +
+ +     0 +
+ +++++++ +
+B    +   +
+ +++ + + +
+   + +   +
+++ + + +++
+   + + + +
+++++ + + +
+   + + + +
+ +   + + +
+ +   +   +
+++++++++ +
+         +
+++++++++++
#end
