#domain
hospital
#levelname
G105
#colors
blue: 0, 1, 2, 3, 4, 5, B
#initial
+++++++++
+ +     +
+B      +
+   3 + +
+10   5 +
+4   2  +
+++++++++
#goal
+++++++++
+ + 5   +
+      2+
+  41 + +
+   3B  +
+   0   +
+++++++++
#end
