#domain
hospital
#levelname
G107
#colors
blue: 0, A, B, E, C
#initial
+++++++++++++
+           +
+  ++++++++ +
+         + +
+ +  ++++ + +
+ + +   E + +
+ +++ + + + +
+ +   +   + +
+ B  ++++++C+
+ +     +   +
+ +++   + +++
+ +A  + + + +
+ +0+++ + + +
+   +   +   +
+++++++ +++ +
+         + +
+ +B+++++ + +
+   +     + +
+ + +++++++ +
+ +         +
+++++++++++++
#goal
+++++++++++++
+           +
+  ++++++++ +
+       C + +
+ +  ++++ + +
+ + +B    + +
+ +++ + + + +
+ +   +   + +
+    ++++++ +
+ + B   +   +
+ +++   +E+++
+ +   + + + +
+ + +++ + + +
+   +   +   +
+++++++ +++ +
+         +A+
+ + +++++ + +
+   +     + +
+ + +++++++ +
+ +         +
+++++++++++++
#end
