#domain
hospital
#levelname
G108
#colors
blue: 0, B, C
#initial
+++++++++
+ 0   + +
+ +++ + +
+   +   +
+ + +++++
+ +C    +
+ +++++ +
+ +     +
+ + +++ +
+ + +   +
+ + + + +
+ + + + +
+ + + + +
+     + +
+ + + +++
+ + +   +
+ +++++ +
+ +     +
+ + B++ +
+   +   +
+++++++++
#goal
+++++++++
+     + +
+ +++ + +
+   +   +
+ + +++++
+ +     +
+ +++++ +
+ +     +
+ + +++ +
+ + +   +
+ + + + +
+ +0+ + +
+ + + + +
+     + +
+ + +B+++
+ + +   +
+ +++++ +
+ +     +
+ +  ++ +
+   +   +
+++++++++
#end
