#domain
hospital
#levelname
G111
#colors
blue: 0
#initial
+++++++++++++++
+     +       +
+ +++ + +++++ +
+ +   + +     +
+ + +++ + +++ +
+ + +   +   + +
+ + + +++++ +++
+ +   +   +   +
+ +++++ + +++ +
+     + +     +
+ +++++ +++++ +
+     + +   + +
+ +++ + +++ +0+
+   +   +   + +
+++ +++++ + + +
+   + +   + + +
+ +++ + + +++ +
+ +     +     +
+++++++++++++++
#goal
+++++++++++++++
+     +       +
+ +++ + +++++ +
+ +   + +     +
+ + +++ + +++ +
+ + +   +   + +
+ + + +++++ +++
+ +   +   +   +
+ +++++ + +++ +
+     + +     +
+ +++++ +++++ +
+     + +   + +
+ +++ + +++ + +
+   +   +   + +
+++ +++++ + + +
+   + +   + + +
+ +++ + + +++ +
+ +     +     +
+++++++++++++++
#end
