#domain
hospital
#levelname
G112
#colors
blue: 0, 1, 2, 3, 4, 5, 6, B, E, C, D
#initial
+++++++++++++
+ D      6  +
+ +++ + + +5+
+       2   +
+  E++ +0 + +
+ +    4    +
+   ++C +++++
+ +         +
+ + + +++ +++
+   +   +   +
+ ++3+  ++B +
+     1     +
+++++++++++++
#goal
+++++++++++++
+ 0         +
+ +++ +5+ + +
+   C    2  +
+ B4++D+  + +
+ +         +
+   ++  +++++
+ + 6       +
+ + + +++ +++
+   +   +   +
+ ++ +1 ++  +
+           +
+++++++++++++
#end
