#domain
hospital
#levelname
G118
#colors
blue: 0, 1, 2, A, B
#initial
+++++++++++
+   +     +
+ A + +  ++
+A+B      +
+++++ +++ +
+         +
+ ++ ++++ +
+ +   +   +
+ ++  +1+ +
+0  + 2 + +
+ +A+ +   +
+       + +
+++++++++++
#goal
+++++++++++
+   +2    +
+   + +  ++
+ +       +
+++++ +++B+
+         +
+ ++ ++++ +
+ +   +   +
+ ++  + + +
+   +   + +
+ + + +   +
+     1 +A+
+++++++++++
#end
