#domain
hospital
#levelname
G122
#colors
blue: 0, 1, 2, 3, A, B
#initial
+++++++++++++++
+           + +
+++1++++  B + +
+ +       +   +
+   0  +++++  +
+ +  B    +   +
+ +A+++++   + +
+       23+   +
+++++++++++++++
#goal
+++++++++++++++
+ 0         + +
+++ ++++    + +
+ +       +   +
+      +++++  +
+ +       +A  +
+ + +++++   + +
+   3     + B +
+++++++++++++++
#end
