#domain
hospital
#levelname
G123
#colors
blue: 0, A, E, C
#initial
+++++++++++++++++++
+     +           +
+ A++ + + +++ + +++
+       +   + +   +
+ +++++++++ +++++ +
+   +   +       + +
+ + + + ++++E + + +
+ + + +       +   +
+++ + +  ++++ +++++
+   +   + +   +C  +
+ +++++ + + +++ A0+
+         +       +
+++++++++++++++++++
#goal
+++++++++++++++++++
+     +           +
+  ++ + + +++ + +++
+       +   + +   +
+ +++++++++ +++++ +
+   +   +       + +
+ + + +E++++  + + +
+ + + +       +   +
+++ + +  ++++ +++++
+A  +   + +   +   +
+ +++++ + + +++   +
+         +       +
+++++++++++++++++++
#end
