#domain
hospital
#levelname
G126
#colors
blue: 0
#initial
+++++++++
+       +
++++0   +
+     + +
+++++++ +
+ +   + +
+ + + + +
+ + +   +
+ + +++++
+       +
+++++++++
#goal
+++++++++
+       +
++++    +
+     + +
+++++++ +
+ +   + +
+ + + + +
+ + +   +
+ + +++++
+       +
+++++++++
#end
