#domain
hospital
#levelname
G129
#colors
blue: 0, A, B
#initial
+++++++++++++++++
+               +
+ +++ +++ + + +++
+ A +     + +   +
+ + ++++++B++++B+
+ +             +
+A+++ + + +++++ +
+A+     +       +
+ + + +++ + +++ +
+ 0 +     +     +
+++++++++++++++++
#goal
+++++++++++++++++
+               +
+ +++ +++ + +A+++
+   +     + +   +
+ + ++++++ ++++ +
+ +        B A  +
+ +++ + + +++++ +
+ +     +       +
+ + + +++ + +++ +
+   +     +  A  +
+++++++++++++++++
#end
