#domain
hospital
#levelname
G130
#colors
blue: 0, 1, 2, A, B, C
#initial
+++++++++++++++++++
+       +   0     +
+ +++++++++++   + +
+     +     + + + +
+++ + + +2+ + + + +
+   +   + + + + + +
+ ++B +++ + +++ + +
+ +       + +   + +
+ + +++ +++ + ++  +
+   + +     + + + +
+ +++ +++++++ + + +
+ +   +     + + + +
+ + + +++ + + + + +
+ + +   + + A + + +
+ + +++ + C++++ + +
+   +   + +     + +
+++++ ++  + + +++ +
+         +    1  +
+++++++++++++++++++
#goal
+++++++++++++++++++
+       +         +
+ +++++++++++   + +
+     +     + + + +
+++ + + + + + + + +
+   +   + + + + + +
+2++  +++ + +++ + +
+ +       + +   + +
+ + +++ +++ + ++  +
+   + +     + + + +
+ +++ +++++++ + + +
+ +   +     + + + +
+ + + +++ + + + + +
+ + +   + +   + + +
+ + +++0+  ++++ + +
+   +   + +     + +
+++++ ++  + + +++ +
+         +C      +
+++++++++++++++++++
#end
