#domain
hospital
#levelname
G133
#colors
blue: 0, B, C
#initial
+++++++++++++++
+             +
+ + +++++++ +++
+ + +   + B + +
+ +++ + + +++ +
+   + + + +   +
+++ + + +++ +++
+   + +   + + +
+ +++ + + + + +
+ + C + +   + +
+ + +++ ++0++ +
+ + +         +
+ + + ++++ ++ +
+             +
+++++++++++++++
#goal
+++++++++++++++
+             +
+ + +++++++ +++
+ + +   +   + +
+ +++ + + +++ +
+   + + + +   +
+++ + + +++ +++
+   + +   + + +
+ +++ +B+ + + +
+0+ C + +   + +
+ + +++ ++ ++ +
+ + +         +
+ + + ++++ ++ +
+             +
+++++++++++++++
#end
