#domain
hospital
#levelname
G134
#colors
blue: 0, 1, 2, 3, 4, 5, 6, A, B, C, D
#initial
+++++++++++++++++++
+ +  3+           +
+ + +   + +++++  ++
+   + + +   +     +
+++++ + + +C ++ + +
+    A+   + A A4+ +
+  ++ +++++++ + + +
+ 0    25 D + +   +
+ +++ + +1A++  ++ +
+   + +     6 +   +
+ +   + ++++ +    +
+         A  B  + +
+++++++++++++++++++
#goal
+++++++++++++++++++
+ +   +5          +
+ + +   + +++++  ++
+B  + + +   +   A +
+++++ +6+ +  ++ + +
+     +   +     +D+
+  ++ +++++++ + + +
+       A   + +   +
+ +++ + +  ++  ++ +
+3  + +       +   +
+ + 1 + ++++ +    +
+    4     A    + +
+++++++++++++++++++
#end
