#domain
hospital
#levelname
G137
#colors
blue: 0, A, B
#initial
+++++++++++++++
+   +   + B  0+
+ + + + A++++ +
+ + + +       +
+++ A+ ++++++ +
+   A       + +
+ +++++ +++++ +
+ +     +     +
+ + +++++ +++++
+ + +   +   + +
+ + ++  +++ + +
+ +     +     +
+ +++ + + +++ +
+   +   + +   +
+   +++++ +++ +
+ +     + +   +
+ ++++A + + + +
+     +       +
+++++++++++++++
#goal
+++++++++++++++
+   +   +     +
+ + + +  ++++ +
+ + + +       +
+++  + ++++++ +
+           +A+
+ +++++ +++++ +
+ +     +     +
+ + +++++ +++++
+ + +B  +   + +
+ +0++  +++ + +
+ +     +     +
+ +++ + + +++ +
+   +   + +   +
+   +++++ +++ +
+ +     + +   +
+ ++++  + + + +
+     +       +
+++++++++++++++
#end
