#domain
hospital
#levelname
G138
#colors
blue: 0, 1, 2, 3, 4, A, B
#initial
+++++++++++
+ 0   +3  +
+4 +    A +
+     +   +
+ A +B+ 2 +
+B+ + + + +
+ + 1     +
+   +     +
+++++++++++
#goal
+++++++++++
+ 3   +   +
+A +1     +
+     + B +
+   +0+ 2 +
+ + + + + +
+ +      B+
+   +A4   +
+++++++++++
#end
