#domain
hospital
#levelname
G142
#colors
blue: 0, A, B, C, D
#initial
+++++++++++++++++++
+       +   +     +
+ ++B + +   ++++  +
+   + +   +   +   +
+ +++ + +++++ + + +
+ +   +   +   + + +
+++ ++++  + +++ + +
+B  + 0   +   C   +
+ +++ +++ ++++A+  +
+ A   +   + +     +
+ +++ + +++ + +++++
+B    +     + +   +
+ + +++++++++ + +++
+ + +   + D   +   +
+ + + + +  ++++++ +
+ +   +           +
+++++++++++++++++++
#goal
+++++++++++++++++++
+       +B  +     +
+ ++  + +   ++++  +
+   + +   +   +   +
+ +++ + +++++ + + +
+ +   +   +   + + +
+++ ++++  + +++ + +
+   +     + A     +
+ +++ +++ ++++ +  +
+   B +   + +     +
+ +++ + +++ + +++++
+     +   A + +   +
+ + +++++++++ + +++
+ + +   +     +   +
+ + + + + 0++++++ +
+ +   +           +
+++++++++++++++++++
#end
