#domain
hospital
#levelname
G144
#colors
blue: 0, A, E, D
#initial
+++++++++++++++++++++
+   +       +     + +
+ + + ++0 + + + + A +
+ +       + +   +   +
+++++ + +++ + +++++ +
+   + + + + +   +   +
+ +++ + + E + + +A+++
+ +   + +   + + +   +
+ +++ + + + +++ +++ +
+   + +   +       + +
++D + +++ +++ + + +++
+   +     + + + +   +
+ +++++ +++ + +++ + +
+       +   +   + + +
+++++++++ +++++ +++ +
+                   +
+++++++++++++++++++++
#goal
+++++++++++++++++++++
+   +       +     + +
+ + + ++  + + + +   +
+ +       + +  A+   +
+++++ + +++ + +++++ +
+   + + + + +   +   +
+ +++ + +  0+ + + +++
+ +   + +   + + +   +
+ +++ + + + +++ +++ +
+   + +   +       + +
++  + +++ +++ + + +++
+   +     + + + +   +
+ +++++ +++ + +++ + +
+       +   +   + + +
+++++++++ +++++ +++ +
+        D     E    +
+++++++++++++++++++++
#end
