#domain
hospital
#levelname
G148
#colors
blue: 0, 1, 2, 3, 4, B
#initial
+++++++++++++++++++
+                 +
+ +++ + +++++++ + +
+     +0    + + + +
+ +++++++++4+  ++ +
+   B     2 +   + +
+ ++ ++ +++++++ + +
+ +       + +   + +
+ + +++ + + + +++ +
+ + + +  1+ + +   +
+ + +3+ +++ + +++ +
+   +       +     +
+++++++++++++++++++
#goal
+++++++++++++++++++
+3                +
+ +++ + +++++++ + +
+     +     + + + +
+ +++++++++ +  ++ +
+           +2  + +
+ ++ ++ +++++++ + +
+ +    B  + +   + +
+ + +++ + + + +++ +
+ + + +   + + +   +
+ + + + +++ + +++ +
+   +       +     +
+++++++++++++++++++
#end
