#domain
hospital
#levelname
G151
#colors
blue: 0, 1, 2, 3, 4, 5, A, C, D
#initial
+++++++++++++++++++++
+     +     A  0    +
+A+++   +++++++++  ++
+     5 +           +
+ +C+   + + + ++ +3 +
+ + + +   + +     + +
+ + + + + + +++ + + +
+   +   + +     + + +
+++ +++A+ +D  A     +
+     4    AA   1 2 +
+++++++++++++++++++++
#goal
+++++++++++++++++++++
+     +         2  C+
+ +++   +++++++++D ++
+A      +           +
+ + +   + + +A++ +  +
+ + + +   + +     + +
+ + + + + + +++ + + +
+   +   +A+     + + +
+++ +++ + +1  A     +
+                   +
+++++++++++++++++++++
#end
