#domain
hospital
#levelname
G152
#colors
blue: 0, A, C, D
#initial
+++++++++++++++++++++
+   +               +
+ ++  + +++C+ ++ ++ +
+ +   + A     +     +
+ 0 +++ ++ D+ +C+A ++
+A      +   +       +
+++++++++++++++++++++
#goal
+++++++++++++++++++++
+   +             A +
+ ++  + +++ + ++ ++ +
+ +   +       +    D+
+   +++ ++  + + +  ++
+       +   +       +
+++++++++++++++++++++
#end
