#domain
hospital
#levelname
G154
#colors
blue: 0, A, C
#initial
+++++++++++++++++++
+ +               +
+ + +++++++++++++ +
+ A +           + +
+ + + +++ +++++ + +
+     +   +     + +
+ +++++ +++  +A++ +
+C+     +     +   +
+ + + +++++++ +++ +
+   +       +   + +
+++ +++++++ +++ + +
+   +A+     +   + +
+0+ + + +++++ +++ +
+ +   + +   + A   +
+ + + + + +++++++ +
+   + + +     +   +
+++ +++ +++++ + + +
+   + +     +   + +
+ +++ +++++ + + + +
+   +       +     +
+++++++++++++++++++
#goal
+++++++++++++++++++
+ +               +
+ +A+++++++++++++ +
+C  +  A        + +
+ + + +++ +++++ + +
+     +   +     + +
+ +++++ +++  + ++ +
+ +     +     +   +
+ + + +++++++ +++ +
+   +  A    +   + +
+++ +++++++ +++ + +
+   + +     +   + +
+ + + + +++++ +++ +
+ +   + +   +     +
+ + + + + +++++++ +
+   + + +     +   +
+++ +++ +++++ + + +
+   + +     +   + +
+ +++ +++++ + + + +
+   +       +    0+
+++++++++++++++++++
#end
