#domain
hospital
#levelname
G157
#colors
blue: 0, 1, 2, A, F
#initial
+++++++++
+       +
+ ++ 1+ +
+ +  0+ +
+2+ +++ +
+   +   +
+ + + +++
+ +F  + +
+ + ++  +
+ + +   +
+ + + + +
+ +   A +
+ +++++ +
+       +
+++++++++
#goal
+++++++++
+       +
+ ++ A+ +
+ +   +0+
+ + +++ +
+   +   +
+ + + +++
+ +   +2+
+1+ ++  +
+ + +   +
+ + +F+ +
+ +     +
+ +++++ +
+       +
+++++++++
#end
