#domain
hospital
#levelname
G158
#colors
blue: 0, 1, A, B, D
#initial
+++++++++++++++
+   +         +
+ + A + + +++ +
+ + B   + +   +
+ +++++++ + +++
+   +     D   +
++   ++ +++ + +
+  10   +     +
+++++++++++++++
#goal
+++++++++++++++
+  1+ 0      A+
+ +   + + +++ +
+ +     + +   +
+ +++++++ + +++
+   + DB      +
++   ++ +++ + +
+       +     +
+++++++++++++++
#end
