#domain
hospital
#levelname
G159
#colors
blue: 0, 1, 2, A, B, C
#initial
+++++++++++++
+   B       +
+ + +++ ++  +
+   +0+ + + +
+ ++  + + + +
+     +2+   +
+++++++  ++ +
+  1C   +   +
+ ++++ ++ + +
+ +   +   + +
+ + C + ++  +
+   +     + +
+ +++++++++ +
+ +     +   +
+++ +++ + +++
+   +   +  A+
+++++A ++++ +
+           +
+++++++++++++
#goal
+++++++++++++
+           +
+ + +++ ++  +
+   + + + + +
+ ++  + + + +
+  C  + +   +
+++++++  ++ +
+   2   +   +
+ ++++ ++ + +
+ +0  +A  + +
+ +   + ++B +
+   +     + +
+ +++++++++ +
+ +     +   +
+++ +++ + +++
+   +   +   +
+++++  ++++ +
+        A  +
+++++++++++++
#end
