#domain
hospital
#levelname
G164
#colors
blue: 0, 1
#initial
+++++++++++++++++++++
+ +       +         +
+ + ++  + + +++++ + +
+ +   + + +   +   + +
+ + +++1+ +++++ +++ +
+ + +   +       + + +
+ + + +++++++++++ + +
+   + +       +     +
+++++ + +++++ +++++++
+     +     +   +   +
+ + +++++++ +++ + + +
+ + +   +   0   + + +
+ +++ + + +++ +++ +++
+ +   +     + +   + +
+ + +++++++ + + +++ +
+           +       +
+++++++++++++++++++++
#goal
+++++++++++++++++++++
+ +       +         +
+ + ++  + + +++++ + +
+ +   + + +   +   + +
+ + +++ + +++++ +++ +
+ + +   +       + + +
+ + + +++++++++++ + +
+   + +       +     +
+++++ + +++++ +++++++
+     +  0  +   +   +
+ + +++++++ +++ + + +
+ + +   +       + + +
+ +++ + + +++ +++ +++
+ +   +     + +   + +
+ + +++++++ + + +++ +
+           +       +
+++++++++++++++++++++
#end
