#domain
hospital
#levelname
G17
#colors
blue: 0, 1, 2, 3, 4
#initial
+++++++++++++++++++++
+                   +
+ + +++++++ ++ ++++ +
+   + +     +   +   +
+++ + + +++++ + + +++
+   + +     + + +   +
+ +++0+ ++++  + +++++
+ +     +     +     +
+ +++++++++++++++++ +
+                 4 +
+ +++++ +++ +++++ + +
+     + +2+ +   + + +
++++  + + + + + +++ +
+   + + +   + +     +
+ + + + + +++ +++++++
+ + + + + 1 + +     +
+ +++ + +++++ +++ + +
+     3 +     +   + +
+ +++++ + + +++ +++ +
+     +         +   +
+++++++++++++++++++++
#goal
+++++++++++++++++++++
+                   +
+ + +++++++ ++ ++++ +
+   + +     +   +   +
+++ + + +++++ + + +++
+   + +     + + +   +
+ +++ + ++++  + +++++
+ +     +     +     +
+ +++++++++++++++++ +
+                   +
+ +++++ +++ +++++ + +
+     + + + +   + + +
++++  + + + + + +++ +
+   + + +   + +     +
+ + + + + +++ +++++++
+ + + + +   + +     +
+ +++ + +++++ +++0+ +
+       +     +   + +
+ +++++ + + +++ +++ +
+   41+         +   +
+++++++++++++++++++++
#end
