#domain
hospital
#levelname
G175
#colors
blue: 0, 1, 2, 3, A, B
#initial
+++++++++++
+        1+
+ +   ++  +
+   +A 30 +
++ + + A B+
+      B  +
+++++++++++
#goal
+++++++++++
+1       B+
+ + 3 ++  +
+   +B    +
++ +A+    +
+ A     2 +
+++++++++++
#end
