#domain
hospital
#levelname
G177
#colors
blue: 0, 1
#initial
+++++++++
+       +
+ + ++  +
+ 1     +
+ +++ +++
+   + 0 +
+++++++++
#goal
+++++++++
+1      +
+ +0++  +
+       +
+ +++ +++
+   +   +
+++++++++
#end
