#domain
hospital
#levelname
G178
#colors
blue: 0, A, C
#initial
+++++++++++++++++
+               +
+ ++  +++++ +++++
+ +   +     +   +
+++ +++C+++++ + +
+   + +   +   + +
+ +++C ++ + +++ +
+ +       + +   +
+ +++++++++ + + +
+ +         + + +
+ + +++ ++ ++ +++
+ +   + +     + +
+ +++ + + +++ + +
+ +   + + +   + +
+ + +++ + +++++ +
+    0  A       +
+++++++++++++++++
#goal
+++++++++++++++++
+               +
+ ++  +++++ +++++
+ +   +     +   +
+++ +++ +++++ + +
+   + +   +   + +
+ +++  ++ + +++ +
+ +       + +   +
+ +++++++++ + + +
+ +         + +C+
+ + +++ ++ ++ +++
+ +   + +     + +
+ +++ + +0+++ + +
+ +   + + +   + +
+ + +++ + +++++ +
+               +
+++++++++++++++++
#end
