#domain
hospital
#levelname
G18
#colors
blue: 0, D
#initial
+++++++++++++
+ +   +     +
+ + +0+ + +++
+   +   +   +
+++++++++++ +
+   +       +
+ + + +++++ +
+ +   + +   +
+++++++ + +++
+       + + +
+ ++++++  + +
+   +     + +
+ + + +++++ +
+ + + +  D  +
+++ + + +++ +
+     + + + +
+ +++ + + + +
+   + + +   +
+ + + + + +++
+ +     +   +
+++++++++++++
#goal
+++++++++++++
+ +   +     +
+ + +D+ + +++
+   +   +   +
+++++++++++ +
+   +       +
+ + + +++++ +
+ +   + +   +
+++++++ + +++
+       + + +
+ ++++++  + +
+   +     + +
+ + + +++++ +
+ + + +     +
+++ + + +++ +
+     + + + +
+ +++ + + + +
+   + + +   +
+ + + + + +++
+ +     +   +
+++++++++++++
#end
