#domain
hospital
#levelname
G180
#colors
blue: 0
#initial
+++++++++
+       +
+ + +++ +
+ +   + +
+ +++ +++
+   +   +
+++++++ +
+     0 +
+ +++ + +
+   + + +
+++ + + +
+   +   +
+  ++++ +
+ +   + +
+ + + + +
+ + + + +
+ + + +++
+   +   +
+ +++++ +
+   +   +
+++++++++
#goal
+++++++++
+       +
+ + +++ +
+ +   + +
+ +++ +++
+   +   +
+++++++ +
+       +
+ +++ + +
+   + + +
+++ + + +
+   +   +
+  ++++ +
+ +   + +
+ + + + +
+ + + + +
+ + + +++
+   +   +
+ +++++ +
+   +   +
+++++++++
#end
