#domain
hospital
#levelname
G184
#colors
blue: 0, A, B, C
#initial
+++++++++++++++++++++
+   +   +      C A  +
+ + +++ + +++++++   +
+ +   +   + +   + + +
+ +++ + +   +++ + + +
+   +   +   +   + + +
+ + +++++++   +   +C+
+ + +   +     + +A+ +
+ + + + + ++A + + 0 +
+ +   +B      +   + +
+++++++++++++++++++++
#goal
+++++++++++++++++++++
+  C+   +           +
+ + +++ + +++++++   +
+ +   +   + +   + + +
+ +++ + +   +++ + + +
+   +   +   +   +A+ +
+C+ +++++++  0+   + +
+ + +   +     + + + +
+ + + + + ++ A+ +   +
+ +   +       +   + +
+++++++++++++++++++++
#end
