#domain
hospital
#levelname
G187
#colors
blue: 0, A, B, C, D
#initial
+++++++++++++
+          C+
+ + +++++++ +
+   +0    + +
+ +++ +++ A +
+ +   +     +
+ + +++ +++ +
+ +   D +   +
+ + + B + +++
+ + + + +   +
+++ + + + + +
+     + + + +
+ +++++ + + +
+ +   B   + +
+  ++++++++ +
+         + +
+++ +++++ + +
+           +
+++++++++++++
#goal
+++++++++++++
+    D    C +
+ + +++++++ +
+B  +     + +
+ +++ +++   +
+ +   + A   +
+ + +++ +++ +
+ +     +   +
+ + +   + +++
+ + + + +   +
+++ + + + + +
+     + + + +
+ +++++ + + +
+ +       + +
+  ++++++++ +
+         + +
+++ +++++ + +
+           +
+++++++++++++
#end
