#domain
hospital
#levelname
G189
#colors
blue: 0, A, B, C, D
#initial
+++++++++++++++++++++
+ C         +       +
+ +++++ +++ + +++++ +
+ + +   + + +     + +
+ + + +++ + ++++D + +
+   + +    B+   + + +
+++ + +++  ++   +   +
+  A+   + +   B   + +
++++  + D++ +++++ + +
+  D+ +     +   + + +
+ +   +++++++ + +++ +
+   +   +     + +   +
+ +++++ + +++++ + + +
+       +   +     + +
+++++ +++++  ++++0+ +
+     +   +   + +   +
+ + + + + +++ + + +++
+B+     +     +     +
+++++++++++++++++++++
#goal
+++++++++++++++++++++
+           +       +
+ +++++ +++ + +++++ +
+ + +   + + +     + +
+ + + +++ + ++++  + +
+   + +     +   + + +
+++ +D+++  ++   +   +
+   +B  + +       + +
++++  +  ++ +++++ + +
+   + +     +   + + +
+ +   +++++++ +B+++ +
+   +   +     + +   +
+ +++++ + +++++ + + +
+       +C  + D   + +
+++++ +++++  ++++ + +
+     +   +   + + A +
+ + + + +0+++ + + +++
+ +     +     +     +
+++++++++++++++++++++
#end
