#domain
hospital
#levelname
G19
#colors
blue: 0, B, D
#initial
+++++++++++++++
+             +
+ +++ 0   D   +
+   + + + + + +
+++++ + + + + +
+     +     + +
+++++++++++++++
#goal
+++++++++++++++
+ B      D    +
+ +++         +
+   + + + + + +
+++++ + + + + +
+    B+     +0+
+++++++++++++++
#end
