#domain
hospital
#levelname
G194
#colors
blue: 0, 1, 2
#initial
+++++++++++++++++++++
+     +   +   +   + +
+ +++ + +++ + + + + +
+   +   +   + + + + +
+++ +++++ +++ + + + +
+   +     + +   + + +
+ +++ +++++ +++++++ +
+   +       +   +1  +
+ + +++++++ +++ + + +
+ +       +   +   + +
+++ +++++++++ + +++ +
+   +       + +   + +
+   + +++ + + +++++2+
+ + + + + + +   +   +
+ +++ + + +++++ + +++
+   +   +       +   +
+ + +++ ++++++++++  +
+ +   +     +       +
+ +++ +++++  ++ +++ +
+   +           +0  +
+++++++++++++++++++++
#goal
+++++++++++++++++++++
+     +   +   +   + +
+ +++ + +++ + + + + +
+   +   +   + + + + +
+++ +++++ +++ + + + +
+   +     + +   + + +
+ +++ +++++ +++++++ +
+   +       +   +   +
+ + +++++++ +++ + + +
+ +       +   +   + +
+++ +++++++++ + +++ +
+ 1 +       + +   + +
+   + +++ + + +++++ +
+ + + + + + +   +   +
+ +++ + + +++++ + +++
+   +   +       +   +
+ + +++ ++++++++++  +
+ +   +     +       +
+ +++ +++++  ++ +++ +
+   +       2   +   +
+++++++++++++++++++++
#end
