#domain
hospital
#levelname
G196
#colors
blue: 0, A
#initial
+++++++++
+ +     +
+ +  ++ +
+ + + + +
+ + + + +
+   + + +
+ +++ + +
+   + +A+
+++ + + +
+     + +
++++++A +
+0      +
+ +++++ +
+   +   +
+ + +  ++
+ + +   +
+ + + +++
+ +     +
+++++++++
#goal
+++++++++
+ +     +
+ +  ++ +
+ + + + +
+ + + + +
+   + + +
+ +++ + +
+ 0 + + +
+++ + + +
+     + +
++++++  +
+       +
+ +++++ +
+  A+   +
+ + +  ++
+ + +   +
+ + + +++
+ +     +
+++++++++
#end
