#domain
hospital
#levelname
G197
#colors
blue: 0, C
#initial
+++++++++
+       +
+ +++++ +
+ +   + +
+ + + + +
+ + + + +
+ + + + +
+ C + + +
+ +++   +
+ +0+   +
+ + +++++
+ +     +
+ + ++ ++
+ +     +
+ +++++ +
+       +
+++++++ +
+       +
+++++++++
#goal
+++++++++
+       +
+ +++++ +
+ +   +0+
+ + + + +
+ + + + +
+ + + + +
+   + + +
+ +++   +
+ + +   +
+ + +++++
+ +     +
+ + ++ ++
+ +     +
+ +++++ +
+       +
+++++++ +
+       +
+++++++++
#end
