#domain
hospital
#levelname
G198
#colors
blue: 0, A, C
#initial
+++++++++++++
+       A + +
+ +++++ + + +
+ + +A+ +   +
+   + + +++++
+ + + + 0   +
+ + +  ++ + +
+   +   + + +
++A +A  + C +
+ +   +   + +
+ + + + ++  +
+     +     +
+++++++++++++
#goal
+++++++++++++
+         + +
+ +++++ + + +
+ + + + +   +
+   + + +++++
+ + + +     +
+ + +  ++ + +
+   +   + + +
++  +   +   +
+ +   +   + +
+ + + + ++  +
+   A +     +
+++++++++++++
#end
