#domain
hospital
#levelname
G2
#colors
blue: 0, A, B, C
#initial
+++++++++++++++
+ +   +    0  +
+ + B + +++++ +
+   +   +   + +
+ +++++A+ + + +
+     +   +   +
+  ++ + +++ + +
+C  + +       +
++  + +++ + + +
+ + +B  + + + +
+   +++ +++ +A+
+           A +
+++++++++++++++
#goal
+++++++++++++++
+ + A +       +
+ +   + +++++ +
+   +   +   + +
+ +++++ + + + +
+   BA+   +   +
+  ++ + +++ + +
+   + +       +
++  + +++ + +A+
+ + +   + + + +
+   +++ +++ + +
+      B      +
+++++++++++++++
#end
