#domain
hospital
#levelname
G21
#colors
blue: 0, A, B, C
#initial
+++++++++++++++++++++
+    B  + +         +
+ ++  + + ++++++++  +
+     +       +     +
+ ++   ++++++B+ +A+ +
+   +         + +C+ +
+++ +++++ +++ + +   +
+          0+   A   +
+++++++++++++++++++++
#goal
+++++++++++++++++++++
+       + +         +
+ ++  + + ++++++++  +
+     +   A   + B   +
+ ++   ++++++ + +0+ +
+   +         + + + +
+++ +++++ +++ + +   +
+           +       +
+++++++++++++++++++++
#end
