#domain
hospital
#levelname
G214
#colors
blue: 0, A, B, C
#initial
+++++++++++++++++++++
+     +          A  +
+  ++ +  +++++ ++ + +
+   + + A   0   +   +
++  + + +AC +++++ + +
+   + + +   +   +   +
+ +++ + + +   + + + +
+ A +  A+ + + + + +A+
+ + +++++ +++ + +   +
+   +     +   + + B +
+++ +++ + + +++ + + +
+       + +   +     +
+++++++++++++++++++++
#goal
+++++++++++++++++++++
+     +             +
+  ++ +  +++++ ++ + +
+   + +         +   +
++  + + +   +++++ + +
+   +A+ +   +   +   +
+ +++ + + +   + + + +
+   +   + + + + + + +
+ + +++++ +++ + +   +
+   +     +  A+ +   +
+++ +++ + + +++A+ + +
+ 0 A   + +  C+     +
+++++++++++++++++++++
#end
