#domain
hospital
#levelname
G216
#colors
blue: 0, A, C, D
#initial
+++++++++++
+   +     +
+ ++  + +A+
+ +   +   +
+ + +++++ +
+   +   + +
+ +++ + + +
+ +   +   +
+ + +C+++++
+   +     +
+++ + + +++
+   + +   +
+ +++++++ +
+ +   +   +
+ + + +  ++
+   +   0 +
+++++++++++
#goal
+++++++++++
+   +     +
+ ++  + + +
+ +   +   +
+ + +++++ +
+  D+   + +
+ +++ + + +
+ +C  +   +
+ + + +++++
+ A +     +
+++ + + +++
+   + +   +
+ +++++++ +
+ +   +   +
+ + + +  ++
+0  +     +
+++++++++++
#end
