#domain
hospital
#levelname
G217
#colors
blue: 0, 1, 2, 3, B
#initial
+++++++++++
+       + +
+ ++1 3++ +
+   +     +
+++B+++ +++
+ 0   +   +
+ +++ + + +
+     + + +
+  +++ ++ +
+ +       +
+  2+ + + +
+     +   +
+++++++++++
#goal
+++++++++++
+       + +
+ ++   ++ +
+   +3    +
+++ +++ +++
+   0 +   +
+ +++ + + +
+     + + +
+  +++ ++ +
+ +       +
+   + +1+ +
+  B  +   +
+++++++++++
#end
