#domain
hospital
#levelname
G219
#colors
blue: 0, 1, 2, 3, 4, 5, A, C
#initial
+++++++++++
+A  2     +
+   + 5 + +
+ +       +
+  ++++ +++
+4    +   +
+ + +C+++ +
+1  +     +
+ +++0+ 3 +
+ +   +   +
+ +  ++++ +
+ +       +
+++++++++++
#goal
+++++++++++
+5A       +
+   +1  + +
+ +      4+
+  ++++ +++
+     +   +
+ + + +++ +
+   +     +
+ +++ +   +
+ +   +   +
+ +  ++++ +
+ +       +
+++++++++++
#end
