#domain
hospital
#levelname
G220
#colors
blue: 0, A, B, D
#initial
+++++++++++++
+B    + +   +
+ +++B+  ++ +
+   +   A  A+
+   +++ +  D+
+ +      0  +
+++++++++++++
#goal
+++++++++++++
+0    + + B +
+ +++A+ D++ +
+   +       +
+   +++ +   +
+ + B       +
+++++++++++++
#end
