#domain
hospital
#levelname
G221
#colors
blue: 0, 1, A
#initial
+++++++++++++++
+           + +
+ +++++ + + + +
+ +   +   + + +
+ + + +++++ + +
+ + +    0+ + +
+ + +++++ + + +
+ +   +   +   +
+++++ + + +++ +
+1      +   + +
+ +++++ ++++  +
+   +   +     +
+ + +++ + +++A+
+ +   + +     +
+ +++ + +++++ +
+ +   + +   + +
+ + +++++ + + +
+ +       +   +
+++++++++++++++
#goal
+++++++++++++++
+           + +
+ +++++ + + + +
+ +   +   + + +
+ + + +++++ + +
+ + +     + + +
+ + +++++ + + +
+ +  A+   +   +
+++++ + + +++ +
+       +   + +
+ +++++ ++++  +
+   +   +     +
+ + +++ + +++ +
+ +   + +     +
+ +++ + +++++ +
+ +   +1+   + +
+ + +++++ + + +
+ +       +   +
+++++++++++++++
#end
