#domain
hospital
#levelname
G223
#colors
blue: 0, A, E, C, D, B
#initial
+++++++++++++++++++
+   E +           +
+ +++ + +++ ++A++ +
+ +A C+   +   + + +
+ + +++++++++ + + +
+ +         + +   +
+ ++++++++++  + +++
+ + + 0       +   +
+ + C +++ +++ ++  +
+ +     + +       +
+   +++++ + ++ ++++
+ + +     +       +
+ +++ A+++++ ++++ +
+ +   + +       + +
+ + +++   +++ ++  +
+   + B    D      +
+++++++++++++++++++
#goal
+++++++++++++++++++
+     +B          +
+ +++ + +++ ++ ++ +
+ +   +   +   + +A+
+E+ +++++++++ + + +
+ +         + +   +
+ ++++++++++  + +++
+ + +         +   +
+ +   +++ +++ ++  +
+ +A    + +       +
+   +++++ + ++ ++++
+ + +     +       +
+ +++  +++++ ++++ +
+ +   + +       + +
+ + +++   +++ ++C +
+   +           A +
+++++++++++++++++++
#end
