#domain
hospital
#levelname
G227
#colors
blue: 0, 1, A, B, C
#initial
+++++++++++
+ 0     + +
+  ++++   +
+     +   +
+ + 1+++A +
+       + +
+ + +++++ +
+     C   +
+  ++ + +++
+   +   B +
+++++++++++
#goal
+++++++++++
+       + +
+  ++++   +
+     +1C +
+ +  +++ 0+
+       + +
+ + +++++ +
+         +
+  ++ + +++
+   +     +
+++++++++++
#end
