#domain
hospital
#levelname
G230
#colors
blue: 0
#initial
+++++++++++
+         +
+ + +++++ +
+ + +   + +
+ ++0 + +++
+     +   +
+ +++++++ +
+ +       +
+ + +++++++
+ +       +
+ +++++++ +
+   +     +
+ + + +++++
+   + +   +
+ +++ + +++
+ + + +   +
+ + +++ + +
+ +   + + +
+ + + +++ +
+   +     +
+++++++++++
#goal
+++++++++++
+         +
+ + +++++ +
+ + +   + +
+ ++  + +++
+     +   +
+ +++++++ +
+0+       +
+ + +++++++
+ +       +
+ +++++++ +
+   +     +
+ + + +++++
+   + +   +
+ +++ + +++
+ + + +   +
+ + +++ + +
+ +   + + +
+ + + +++ +
+   +     +
+++++++++++
#end
