#domain
hospital
#levelname
G233
#colors
blue: 0, 1, A, B, D
#initial
+++++++++++++++++++
+0+               +
+ + +++++B+++++++ +
+   +A    +     A +
+ + +++ +   + + + +
+ +   + 1   +   + +
+ + + +++++ + +++ +
+             +   +
+ +++ ++++ ++ + + +
+ + +   +   + + + +
+ + + + D + +++ + +
+ + +A+   + +   + +
+ + + +++++ + +++ +
+   + +       +   +
+++++++++++++++++++
#goal
+++++++++++++++++++
+ +               +
+ + +++++ +++++++ +
+   +     + A     +
+ + +++ +   + + + +
+ +   +     +   + +
+ + + +++++ + +++ +
+             +   +
+ +++ ++++ ++ + + +
+ + +   +   + + + +
+ + + +   + +++0+ +
+ + + +   + +   + +
+ + + +++++ + +++ +
+   + + B     +   +
+++++++++++++++++++
#end
