#domain
hospital
#levelname
G234
#colors
blue: 0, A, F, C
#initial
+++++++++++++++++
+0  + C         +
+++ + + +  ++A+ +
+     +   + +   +
+ +++F+ + + +  ++
+        A+     +
+++++++++++++++++
#goal
+++++++++++++++++
+   +   F      A+
+++ + + +  ++ + +
+     +   + +   +
+ +++ + + + +A ++
+C        +     +
+++++++++++++++++
#end
