#domain
hospital
#levelname
G238
#colors
blue: 0, A, B, D
#initial
+++++++++
+ +     +
+ + ++  +
+   + +D+
+++0+ + +
+ B     +
+   + +++
+   +   +
+ + +++ +
+ +   + +
+ + +++ +
+ A     +
+++++++++
#goal
+++++++++
+ + 0   +
+ + ++A +
+   + + +
+++ + + +
+       +
+   + +++
+   +B  +
+ + +++ +
+ +  D+ +
+ + +++ +
+       +
+++++++++
#end
