#domain
hospital
#levelname
G24
#colors
blue: 0, 1, 2, 3, F
#initial
+++++++++++++++++
+F+             +
+ + +++++ +++++ +
+ + +   + + 0   +
+ + +++ + +++++ +
+ +     +     + +
+ +++ +++++++ + +
+ +   +   +   + +
+ + + + + + +++ +
+   +   +   +   +
+++++ +++++++ +++
+   + +   +   + +
+ + + + + + +++ +
+ +   + + + +   +
+3+++++ + + + + +
+     + +     + +
+ + + + + +++++ +
+ +   + +   1   +
+ + ++   ++++ 2++
+ + +           +
+++++++++++++++++
#goal
+++++++++++++++++
+ +             +
+ + +++++ +++++ +
+ + +   + +     +
+ + +++ + +++++ +
+ +     +     + +
+ +++ +++++++ + +
+ +   +   +  1+ +
+ + + + + + +++ +
+   +   +   +   +
+++++F+++++++ +++
+   + +   +   + +
+2+ + + + + +++ +
+ +   + + + + 0 +
+ +++++ + + + + +
+     + +     + +
+ + + + + +++++ +
+ +   + +       +
+ + ++   ++++  ++
+ + +           +
+++++++++++++++++
#end
