#domain
hospital
#levelname
G240
#colors
blue: 0, A, B
#initial
+++++++++++++
+   +   +   +
+ +A    +   +
+  A A+   + +
++0++++++++ +
+   +     + +
+++ +  +  + +
+     + B   +
+++++++++++++
#goal
+++++++++++++
+0  +  A+   +
+ +     +   +
+     +   + +
++ ++++++++ +
+   +     + +
+++ +  +  + +
+     +     +
+++++++++++++
#end
