#domain
hospital
#levelname
G242
#colors
blue: 0, A, B, E, C
#initial
+++++++++++++++++++
+     +           +
+++ + +++++ + + +++
+   +       + +   +
+++++ +++++ + +++ +
+       +   + +   +
+ +++++ + + ++  B +
+     + +   +   + +
+ +++  ++++ + +++ +
+   +    E  +B  +0+
+++ ++C +++ +++ +A+
+           A   + +
+++++++++++++++++++
#goal
+++++++++++++++++++
+     +           +
+++ + +++++ + + +++
+   +B      + +   +
+++++ +++++ +A+++ +
+       +   + +   +
+ +++++ + + ++ B  +
+  A E+ +C  +   + +
+ +++  ++++ + +++ +
+   +       +   + +
+++ ++  +++ +++ + +
+               + +
+++++++++++++++++++
#end
