#domain
hospital
#levelname
G243
#colors
blue: 0, 1, A, B, D
#initial
+++++++++++++
+  0+D    A +
+++ +  +++B +
+  A+ +   + +
+  ++ +++ + +
+   + + +   +
+ + 1 + +++++
+ +   +     +
+ +++  ++++ +
+         + +
+  ++++++ + +
+           +
+++++++++++++
#goal
+++++++++++++
+   +       +
+++ +0 +++  +
+   + +   + +
+  ++ +++ + +
+1  + + +   +
+ +   + +++++
+ +   +    A+
+ +++  ++++ +
+       B + +
+  ++++++ + +
+           +
+++++++++++++
#end
