#domain
hospital
#levelname
G249
#colors
blue: 0, 1, 2, 3, 4, 5, D
#initial
+++++++++++++++
+  2      0   +
+ +5+ +3+ + + +
+   +     + + +
+ + + +   + + +
+ +  1+ + + + +
+ +++++ + + +4+
+   +  D+ +   +
+ + + ++  + + +
+ +     + +   +
+++++++++++++++
#goal
+++++++++++++++
+         3   +
+ + + + + + + +
+   +     + + +
+ + + +   + + +
+1+   + + + + +
+ +++++ + +D+ +
+ 0 +4  + +  2+
+ + + ++  + + +
+ +     + +   +
+++++++++++++++
#end
