#domain
hospital
#levelname
G254
#colors
blue: 0, 1, 2, B
#initial
+++++++++
+     + +
+   + 2 +
+ +   + +
+ + +0+ +
+ +   + +
+1+ + + +
+ +     +
+++++++++
#goal
+++++++++
+     + +
+   +2  +
+ +   + +
+ + + + +
+ +   + +
+ + + + +
+ +     +
+++++++++
#end
