#domain
hospital
#levelname
G256
#colors
blue: 0, A, C
#initial
+++++++++++++++++++
+     +   A   +   +
+A+++ + + +++ + +++
+   +   +   + +   +
+ + + +++ + +C+ + +
+ + +     +   + + +
+   + +++++ +++ + +
+ +   +     +   + +
+ ++++    A +++++ +
+     + +   +     +
+++ + + + + + + + +
+   +   +     + + +
+ + ++0++++++++ + +
+ + +       + +   +
+ + + ++++A + + +++
+ + + +   A + A + +
+ +++ + + +++ A++ +
+     + +         +
+++++++++++++++++++
#goal
+++++++++++++++++++
+   A +       +   +
+ +++A+ + +++A+ +++
+   +   +   + +   +
+ + + +++ + + + + +
+ + +     +   + + +
+ A + +++++ +++ + +
+ +   +     +   + +
+ ++++      +++++ +
+     + +   +     +
+++ + + + + + + + +
+   +   +     + + +
+ + ++ ++++++++ + +
+ + +       + +   +
+ + + ++++  + + +++
+A+ + +     +   + +
+ +++ + + +++  ++ +
+     + + C A     +
+++++++++++++++++++
#end
