#domain
hospital
#levelname
G258
#colors
blue: 0, 1, 2, A, C
#initial
+++++++++
+       +
+ + + + +
+ + +   +
+ C  ++ +
+     + +
++++  + +
+   + + +
+ + +2+ +
+ + + + +
+ + +++ +
+ +   + +
+ +++10 +
+   A + +
+ + + + +
+ +     +
+++++++++
#goal
+++++++++
+       +
+ + + + +
+ + +   +
+    ++1+
+     + +
++++  + +
+   + + +
+ + + + +
+ + + + +
+ + +++ +
+ +   + +
+ +++   +
+  2  + +
+ + + + +
+ +    C+
+++++++++
#end
