#domain
hospital
#levelname
G264
#colors
blue: 0, 1, 2, A, B, E
#initial
+++++++++++++++++
+     +       + +
+  0+2+ +++++ + +
+       +   + + +
+++ +++++ +   + +
+A  +     + + + +
+++++ +++ + + + +
+ +   +         +
+E+ 1 ++B+++++  +
+   +           +
+++++++++++++++++
#goal
+++++++++++++++++
+     +       + +
+   + + +++++ + +
+     0 +   + + +
+++ +++++ +   + +
+ 2 +     + + + +
+++++ +++ + + +E+
+ +   +         +
+ +   ++B+++++  +
+   +           +
+++++++++++++++++
#end
