#domain
hospital
#levelname
G265
#colors
blue: 0, 1, A, B, C
#initial
+++++++++++++++++
+             + +
+ + ++++++ ++   +
+ +         +   +
+ +++++++++ ++A +
+   +   + +   C +
+++ + + + +++B  +
+ +       +   + +
+   +++++ + +1+++
+ +     B +0+ + +
+   +A+++++A++  +
+            A  +
+++++++++++++++++
#goal
+++++++++++++++++
+             + +
+ + ++++++ ++B  +
+ +         +   +
+ +++++++++ ++  +
+   +   + +     +
+++ + + + +++   +
+ +       +   + +
+   +++++ +A+ +++
+ +       + +C+ +
+ 0 + +++++ ++  +
+              B+
+++++++++++++++++
#end
