#domain
hospital
#levelname
G266
#colors
blue: 0, A, B
#initial
+++++++++
+   +   +
+ + + + +
+  B+ + +
+ + + + +
+ +   +A+
+ +++A+ +
+     + +
+++++ + +
+ + 0 + +
+ + +++ +
+ +     +
+ ++ +  +
+       +
+++++++++
#goal
+++++++++
+   +  0+
+ +A+ + +
+   + + +
+ + + + +
+ +   + +
+ +++ + +
+    A+ +
+++++ + +
+ +   + +
+ + +++ +
+ +     +
+ ++ +  +
+       +
+++++++++
#end
