#domain
hospital
#levelname
G267
#colors
blue: 0, A
#initial
+++++++++
+       +
+ +++++ +
+ +     +
+ ++0+ ++
+   +   +
+++ + + +
+     + +
+ ++  +A+
+     + +
+ +++++ +
+   +   +
+++ + + +
+   A + +
+++++++++
#goal
+++++++++
+       +
+ +++++ +
+A+     +
+ ++ + ++
+   +   +
+++ + + +
+     + +
+ ++  + +
+     + +
+ +++++ +
+   +   +
+++ + + +
+     + +
+++++++++
#end
