#domain
hospital
#levelname
G269
#colors
blue: 0, D
#initial
+++++++++++++++++++++
+     +     +     0 +
+ +++ + +++ + + +++ +
+ +   + +  D    + + +
+++ +++ +++++++++ + +
+   +     +     + + +
+ +++++++ + +++ + + +
+   +     +   +   + +
+++ +  ++++ + + +++ +
+   +   +   + + +   +
+ +++++ + +++ +++ +++
+       +   +       +
+++++++++++++++++++++
#goal
+++++++++++++++++++++
+     +     +       +
+ +++ + +++ + + +++ +
+ +   + +       + + +
+++0+++ +++++++++ + +
+   +     +     + + +
+ +++++++ + +++ + + +
+   +     +   +   + +
+++ +  ++++ + + +++ +
+   +   +   + + +   +
+ +++++ + +++ +++ +++
+       +   +       +
+++++++++++++++++++++
#end
