#domain
hospital
#levelname
G270
#colors
blue: 0, 1, 2, 3, 4, B, C
#initial
+++++++++++++
+       +   +
+ ++  + 4   +
+    0+ + + +
+ +B+   + 2 +
+     + + + +
+ ++ ++  ++ +
+   +  3   1+
+++++++++++++
#goal
+++++++++++++
+       + 0 +
+ ++  +     +
+     + + + +
+ + +4  +2  +
+  3  + + + +
+ ++ ++  ++ +
+   +       +
+++++++++++++
#end
