#domain
hospital
#levelname
G271
#colors
blue: 0, A, B, D
#initial
+++++++++++
+     +   +
+++ + ++  +
+   +   +A+
+ +++++ + +
+ D       +
+ B++++++++
+ +       +
+ +  ++++ +
+   +   + +
+ + + + + +
+     + B +
+++++++ + +
+      0+ +
+  ++ +++ +
+ + +   + +
+ +  ++++ +
+ +       +
+++++++++++
#goal
+++++++++++
+     +  0+
+++ + ++  +
+   +   + +
+ +++++ + +
+A        +
+  ++++++++
+ +       +
+ +  ++++ +
+   +   + +
+ + + + + +
+     +   +
+++++++ + +
+    B  + +
+  ++ +++ +
+ + +   + +
+ +  ++++ +
+ +  D    +
+++++++++++
#end
