#domain
hospital
#levelname
G277
#colors
blue: 0, 1, 2, A, B, D
#initial
+++++++++++++++
+          D  +
+ +++ +++ + + +
+ +     +   + +
+ +++ + +++++ +
+   + +    0  +
+ A +++ + +++++
+ +     + +   +
+++++++ B +A+ +
+     + +   + +
+ + + + +++ + +
+ +     +   + +
+ + +++ 2   + +
+ + 1   + +   +
+ + +++++ +++ +
+ +     +     +
+ ++++ B+ +++++
+     +       +
+++++++++++++++
#goal
+++++++++++++++
+    A        +
+ +++ +++ + + +
+A+     +   + +
+ +++ + +++++ +
+   + +       +
+   +++1+ +++++
+ +     +B+2  +
+++++++   + + +
+     + +   + +
+ + + + +++ + +
+ +     +B  + +
+0+ +++    D+ +
+ +     + +   +
+ + +++++ +++ +
+ +     +     +
+ ++++  + +++++
+     +       +
+++++++++++++++
#end
