#domain
hospital
#levelname
G281
#colors
blue: 0, A, B
#initial
+++++++++++++++++++++
+ +       +        A+
+   + +++++  ++++++A+
+   +   +   +   +   +
+ +++++ +   +++ +++++
+       +         A +
+ 0++ AA++B++++++++ +
+ +   +   +       +A+
+ + +++ + +  ++ +++ +
+ +                 +
+++++++++++++++++++++
#goal
+++++++++++++++++++++
+ +       +     A   +
+   + +++++0 ++++++ +
+   +   +  A+   +   +
+ +++++ +   +++ +++++
+       +           +
+  ++   ++ ++++++++ +
+ +   +   +       + +
+ + +++ + +  ++ +++ +
+ + A    A        A +
+++++++++++++++++++++
#end
