#domain
hospital
#levelname
G288
#colors
blue: 0, A, B, E
#initial
+++++++++++++++
+   +         +
+ ++  ++AE+ 0 +
+ +   +   + + +
+ + +++ +     +
+    B  A   B +
+++++++++++++++
#goal
+++++++++++++++
+   +   A     +
+ ++  ++  +   +
+ +A  +   + + +
+ + +++ +  B  +
+           B +
+++++++++++++++
#end
