#domain
hospital
#levelname
G293
#colors
blue: 0, A
#initial
+++++++++++++
+    A+     +
+ +++ + + +++
+ +   + +   +
+ +++ +++++ +
+   +    A  +
+++++++++++ +
+       +   +
+ +++ +++ +++
+ +     + + +
+ + +++   + +
+ + + +   + +
+  A+ +++++ +
+ +     +   +
+ + +++ +   +
+   0   + + +
+ + + +++++ +
+ +       A +
+++++++++++++
#goal
+++++++++++++
+ 0   +     +
+ +++ + + +++
+ +   + +   +
+ +++ +++++ +
+   +       +
+++++++++++ +
+       +   +
+ +++ +++ +++
+ +     + + +
+ + +++   + +
+ + + +   + +
+   + +++++ +
+ +     +   +
+ + +++ +   +
+       + + +
+ + + +++++ +
+ +         +
+++++++++++++
#end
