#domain
hospital
#levelname
G295
#colors
blue: 0, 1, A, C, D
#initial
+++++++++++++++++
+     C       + +
+ +++ +++++++ + +
+               +
+++++++++ + +A+ +
+         +   + +
+ +++++++++ + + +
+   +   C + +   +
+++ + +++++ +++ +
+ +   +  0      +
+ +++++ +D+++++++
+     1     +   +
+ +++ +++++ +++ +
+ + +     +     +
+ + ++++  + + + +
+ +   +   +   + +
+ +++ + + + + +++
+   + + + + +   +
+++ + + C++ +++ +
+     +         +
+++++++++++++++++
#goal
+++++++++++++++++
+   1         + +
+ +++ +++++++ + +
+               +
+++++++++ + + + +
+         +C  + +
+ +++++++++ + + +
+   +     + +   +
+++ + +++++ +++ +
+ +   +  C      +
+ +++++ + +++++++
+           +   +
+ +++ +++++ +++ +
+ +D+     +     +
+ + ++++  + + + +
+ +   +   +   + +
+ +++ + + + + +++
+   + + + + +   +
+++ + +  ++ +++ +
+     +         +
+++++++++++++++++
#end
