#domain
hospital
#levelname
G302
#colors
blue: 0, A, B
#initial
+++++++++
+      B+
+ +++A+ +
+ +   + +
+ + + +++
+       +
+0+ +++ +
+       +
+++++++++
#goal
+++++++++
+0      +
+ +++ + +
+ +A  + +
+ + + +++
+       +
+ + +++ +
+ B     +
+++++++++
#end
