#domain
hospital
#levelname
G303
#colors
blue: 0, D
#initial
+++++++++
+ +   + +
+ +++ + +
+ +   + +
+ + D++ +
+ + +   +
+ + D + +
+   + + +
+ ++  +++
+ + +   +
+ 0 + + +
+     + +
+ ++ ++ +
+       +
+++++++++
#goal
+++++++++
+ +   + +
+ +++ + +
+ +   + +
+ +  ++ +
+ + +   +
+ +   + +
+   + + +
+ ++  +++
+ + +   +
+   + + +
+   0 + +
+ ++ ++ +
+      D+
+++++++++
#end
