#domain
hospital
#levelname
G307
#colors
blue: 0, A
#initial
+++++++++++++++
+ +   +     + +
+ + +++ +++ + +
+   +   +   +A+
+ +++ +++0A   +
+   +     +   +
+++ +++ + +++++
+     + +     +
+ +++ +++++ + +
+   +     + + +
+ + +++++ + + +
+ + +   + + + +
+ +++ + + +++ +
+     +       +
+ +++++++ + + +
+A    +     + +
+++++ + + +++ +
+   + + + + A +
+ + + + + + + +
+ +       +   +
+++++++++++++++
#goal
+++++++++++++++
+ +   +     + +
+ + +++ +++ + +
+   +   +0  + +
+ +++ +++     +
+   +     +   +
+++ +++ + +++++
+     + +     +
+ +++A+++++ + +
+   +     + + +
+ + +++++ + + +
+ + +   + + +A+
+ +++ + + +++ +
+     +       +
+ +++++++ + + +
+     +     + +
+++++ + +A+++ +
+   + + + +   +
+ + + + + + + +
+ +       +   +
+++++++++++++++
#end
