#domain
hospital
#levelname
G310
#colors
blue: 0, 1, 2, A
#initial
+++++++++++
+   +     +
+ A +   +++
+2+   +   +
+ + ++ ++ +
+ +     + +
+ + + + + +
+   + + + +
+++++ + +++
+    1+   +
+ ++0++ + +
+       + +
+++++++++++
#goal
+++++++++++
+   +2    +
+   +   +++
+ +   +   +
+ + ++ ++ +
+ +     + +
+ + + + + +
+   + + + +
+++++ + +++
+  1  +   +
+ ++ ++ + +
+       + +
+++++++++++
#end
