#domain
hospital
#levelname
G311
#colors
blue: 0, A, B
#initial
+++++++++++
+ +       +
+ + + +++++
+   +     +
+++++++++ +
+        B+
+0++++A++ +
+ +     + +
++  +++++ +
+         +
+   +++++++
+         +
+++++++++++
#goal
+++++++++++
+ +       +
+ + + +++++
+   +     +
+++++++++ +
+         +
+ ++++ ++ +
+ +     + +
++  +++++ +
+         +
+   +++++++
+         +
+++++++++++
#end
