#domain
hospital
#levelname
G312
#colors
blue: 0, 1, 2, 3, 4, A, B, C
#initial
+++++++++++++
+       +   +
+ +++++ + + +
+   +       +
+++ + 4++ +++
+       3   +
+ + +2+A+ + +
+ +   +   + +
+ 0++++ +++ +
+   +   +   +
+ + +  ++ +++
+ +         +
+++++++++++ +
+ 1   +   + +
+ B++ + +   +
+   +   A + +
+++ +++  ++ +
+C          +
+++++++++++++
#goal
+++++++++++++
+       +   +
+ +++++ + + +
+   +       +
+++ +  ++ +++
+       0   +
+ + + + + + +
+ +  2+   + +
+  ++++ +++B+
+   +   +   +
+ + +  ++ +++
+4+       3 +
+++++++++++ +
+     +  1+ +
+  ++ + +   +
+   +     + +
+++ +++  ++ +
+        A  +
+++++++++++++
#end
