#domain
hospital
#levelname
G322
#colors
blue: 0, A, C
#initial
+++++++++++++++++
+     +   +     +
+ +++ +++   +++ +
+ +       + +   +
+ +++++  ++ + + +
+     + +     + +
+ +++ +++ +++++ +
+   +       +   +
++++++ ++++++ +++
+ C         +   +
+ ++++++ ++ +++ +
+ +     +   +   +
+ + +A+ +++ + + +
+   + +   +   + +
+ ++  +0+ +++++ +
+ +   +  C+A    +
+ + + + +C+ +++++
+   + + +       +
+++++++++++++++++
#goal
+++++++++++++++++
+     +   +     +
+ +++ +++   +++ +
+ +       +C+   +
+ +++++  ++C+ + +
+     + +     + +
+ +++ +++ +++++ +
+   +       +   +
++++++ ++++++ +++
+           +   +
+ ++++++ ++ +++ +
+ +     +   +A  +
+ + + + +++ + + +
+   + +   +   + +
+ ++  + + +++++ +
+ + A +   +     +
+ + + + + + +++++
+   + + +   0   +
+++++++++++++++++
#end
