#domain
hospital
#levelname
G323
#colors
blue: 0, A
#initial
+++++++++++++++
+     +       +
+ A++++ + + +++
+ +     + +   +
+ + +++++ + + +
+ 0         + +
+++++++++++++++
#goal
+++++++++++++++
+ A   +       +
+  ++++ + + +++
+ +     + +   +
+ + +++++ + + +
+           + +
+++++++++++++++
#end
