#domain
hospital
#levelname
G324
#colors
blue: 0, A, B, E, C
#initial
+++++++++++++++++
+     +     +   +
+ + + + +C+ +A+ +
+ + + + EB+ + + +
+ + +A+A+   + + +
+ + +   +   + + +
+++ +  ++ ++ ++ +
+   +     +     +
+ ++++ ++ A 0++ +
+       +   +   +
+ +++++   + + + +
+   +   +   +   +
+++ + +++++++++ +
+   +     +     +
+++++++++++++++++
#goal
+++++++++++++++++
+     +    A+   +
+ + + + + + + +C+
+ + + +   + + + +
+ + + +A+   + + +
+ + +   +   + + +
+++ +  ++ ++ ++ +
+   +     +     +
+ ++++ ++    ++ +
+       +   +   +
+ +++++   + + + +
+   +   +   +   +
+++ + +++++++++ +
+ E +     +     +
+++++++++++++++++
#end
