#domain
hospital
#levelname
G326
#colors
blue: 0, A, F, C, D, B
#initial
+++++++++++++++++++++
+     +       +   + +
+ +++++ +++++ + + + +
+ +     +   +   + + +
+ + +A+++  + ++++ + +
+   +      A      + +
+ + ++  +++ +++++++ +
+ +   +   + +     + +
+ ++D +++ + +++ + + +
+   +     +   + +   +
+ +++++ +++++ 0 +++ +
+ +   +           + +
+ + +B+ +++++++B+ +++
+   + + +     + +  C+
+ +++ + + +++ + + + +
+   +  B+   +       +
+++ +++++++++++++++ +
+         F         +
+++++++++++++++++++++
#goal
+++++++++++++++++++++
+     +       +   + +
+ +++++ +++++ + + + +
+ +     +   +   + + +
+ + + +++  + ++++ +B+
+   +         C   + +
+ + ++  +++ +++++++ +
+ +   +   + +     + +
+ ++  +++ + +++ + + +
+   +     +   + +   +
+ +++++ +++++   +++ +
+ +   +           + +
+ + + + +++++++ + +++
+   + + +     + +   +
+ +++ + + +++ + + + +
+   +   +   +       +
+++ +++++++++++++++ +
+           F   A   +
+++++++++++++++++++++
#end
