#domain
hospital
#levelname
G328
#colors
blue: 0, 1, 2, A, B
#initial
+++++++++++++++++
+         +A    +
+ ++ ++++++ + + +
+   +   +   + + +
+ + + + + +++ + +
+ +   + + + +   +
+ + +++ + + + +++
+ +   + + + + 2 +
+ 0 + + + +1+ + +
+   + +   + +B  +
+++++ + + + + +++
+     + +   +   +
+  B+++ + + +++ +
+    B+      A  +
+++++++++++++++++
#goal
+++++++++++++++++
+         +     +
+ ++ ++++++ + + +
+   +   +  B+ + +
+ + + + +2+++ + +
+ + B + + + +   +
+ + +++ + + + +++
+ +   + + + +   +
+   + + + + + + +
+   + +   + +  0+
+++++ + + + + +++
+  1  + +   + B +
+   +++ + + +++ +
+     +  A      +
+++++++++++++++++
#end
