#domain
hospital
#levelname
G331
#colors
blue: 0, 1, A, B
#initial
+++++++++++
+1 A 0+   +
+ +   +   +
+B  + +   +
+++ +   + +
+A  +   + +
+++++++++++
#goal
+++++++++++
+     +   +
+ +   +   +
+   + +   +
+++A+   + +
+   +0  +B+
+++++++++++
#end
