#domain
hospital
#levelname
G334
#colors
blue: 0, A, B, D
#initial
+++++++++++++++++++++
+     +B  +        B+
+ +++ + ++A +++ + +++
+ + + +   +     +   +
+ + + + +D+++++ +++ +
+ +   + +   + + + + +
+ + + + + + + + + + +
+     + +   0 + +   +
+ +   D + +++++ + + +
+ +     +           +
+ ++B++++ +++++++++ +
+ +A    + A +       +
+ + +++ +++++ +++++ +
+ + +   +   + +     +
+ + + +++ + + + B + +
+   +     +   + +   +
+++++++++++++++++++++
#goal
+++++++++++++++++++++
+     +   +         +
+ +++ + ++  +++ + +++
+ + + +D  +     +   +
+ + + + + +++++ +++ +
+ +   + +   + + + + +
+ + + + + + + + + + +
+     + +     + +   +
+ +     + +++++ + + +
+ +     +           +
+ ++ ++++ +++++++++ +
+ +     +   +       +
+ + +++ +++++ +++++ +
+ + +   +   + +     +
+ + + +++ + + + A0+ +
+   +     +   + +   +
+++++++++++++++++++++
#end
