#domain
hospital
#levelname
G338
#colors
blue: 0, 1, 2, 3, 4, 5, 6, A
#initial
+++++++++++++++
+   +         +
+ +0+ + +   + +
+ + + + + 4 + +
+ 2A+ + +   +++
+       +  A  +
+ +++++++ ++A++
+   +     +   +
+   + ++ +  + +
+ + 1A      + +
+5+ +6+++++   +
+ + 3         +
+++++++++++++++
#goal
+++++++++++++++
+   +         +
+ +2+ + +   +A+
+3+ + + +   + +
+   + + +   +++
+       +     +
+ +++++++ ++ ++
+   +   A +   +
+  6+ ++ +  + +
+ +      5  + +
+ + + +++++   +
+ +           +
+++++++++++++++
#end
