#domain
hospital
#levelname
G339
#colors
blue: 0, A, B, C
#initial
+++++++++++++++++++
+         +   +   +
+ + +++++   + +++ +
+ C +     + +   + +
+ + +++++++ + + + +
+ +       +   B A +
+ +++++++ +++ +A+ +
+ +     +     + + +
+ ++++  +++++++ + +
+   + +   +     A +
+++ + B++ +   +++ +
+ +     +   +     +
+ +++++  ++++++ + +
+   + C +       + +
+++ + ++++++  + + +
+   + +     + + + +
+ +++ + 0++ + + + +
+       +     +   +
+++++++++++++++++++
#goal
+++++++++++++++++++
+         +   +   +
+ + +++++   + +++ +
+   +     + +   + +
+ + +++++++ + + + +
+A+     B +   0   +
+ +++++++ +++ + + +
+ +     +   B + + +
+ ++++  +++++++ + +
+   + +   +       +
+++ +  ++ +   +++ +
+ +   A +   +     +
+ +++++  ++++++ + +
+   +   + C     + +
+++ + ++++++  + + +
+   + +     + + + +
+ +++ +  ++ + + + +
+       +     +   +
+++++++++++++++++++
#end
