#domain
hospital
#levelname
G340
#colors
blue: 0, 1, 2, 3, A, C, D
#initial
+++++++++++++++++
+ +     +       +
+ ++++  + 0+++  +
+ D1  A + + +   +
+ +++C+ +   3  A+
+ +     +   +  A+
+ + A    +++  +2+
+           A + +
+++++++++++++++++
#goal
+++++++++++++++++
+ +3A   +     A +
+1++++  +  +++  +
+   2   + + +   +
+0+++ + +       +
+D+     + A +   +
+C+      +++  + +
+             + +
+++++++++++++++++
#end
