#domain
hospital
#levelname
G343
#colors
blue: 0, A, B, C
#initial
+++++++++++++++++++
+       +     +   +
+ +++++ +++ +++   +
+     +     +   + +
+ +++ + ++++A  ++ +
+C  + + +     B   +
+++++ +++ +++++ +++
+     +   + + +   +
+ +++ + +++ + +++ +
+   + +C  + +     +
+ +  0 ++ + +++++ +
+ +               +
+++++++++++++++++++
#goal
+++++++++++++++++++
+       +     +   +
+ +++++ +++ +++   +
+     +     +   + +
+ +++ + ++++   ++ +
+   + + +  C      +
+++++ +++ +++++ +++
+     +   + + +   +
+ +++ + +++ + +++ +
+   + +   + +     +
+ +    ++B+ +++++ +
+ +0    C         +
+++++++++++++++++++
#end
