#domain
hospital
#levelname
G349
#colors
blue: 0, B
#initial
+++++++++++++++
+             +
+ +++++ +++++ +
+ +       +   +
+ + 0++++ + +++
+     +   +   +
++++++  +++++ +
+       +     +
+ +++++++++++ +
+           + +
+ ++++B++++ +++
+   +     +   +
+++ +++++ +++ +
+   +       + +
+ +++ + +++++ +
+     + +     +
+++++++++++++++
#goal
+++++++++++++++
+             +
+ +++++ +++++ +
+ +       +   +
+ +  ++++ + +++
+     +   +   +
++++++  +++++ +
+       +     +
+ +++++++++++ +
+           + +
+ ++++ ++++ +++
+   +     +   +
+++ +++++ +++ +
+   +       + +
+ +++ + +++++ +
+0    + +     +
+++++++++++++++
#end
