#domain
hospital
#levelname
G35
#colors
blue: 0, 1, A, B, E, C
#initial
+++++++++++++++
+ +           +
+ + +++++ +++++
+ +     +  B  +
+ ++++A +++++ +
+   +   + +   +
+ + + +++ + +++
+ + + +   +C  +
+ +0+ + +++++ +
+ + + +A+     +
+  ++ +   +++ +
+       + +   +
++++++++   ++++
+   +   + +   +
+ + A + + + + +
+ 1   + +   + +
+ +++ +  ++++ +
+ +     +     +
+  ++ + +E+++ +
+     +   +   +
+++++++++++++++
#goal
+++++++++++++++
+ +           +
+ + +++++ +++++
+ +     +     +
+ ++++A +++++ +
+   +  E+ +   +
+ + + +++ + +++
+ + + +A  +   +
+ + + + +++++ +
+ + + + +     +
+  ++ + B +++ +
+       + + 0 +
++++++++   ++++
+   +   + +   +
+ +   +A+ + + +
+     + +   + +
+ +++ +  ++++ +
+ +     +     +
+  ++ + + +++ +
+     +   +   +
+++++++++++++++
#end
