#domain
hospital
#levelname
G350
#colors
blue: 0, A, B, C, D
#initial
+++++++++++++++++
+           +   +
++ D+++A + ++ +A+
+   +      B  + +
+0 +   +++++++  +
+  C A        + +
+++++++++++++++++
#goal
+++++++++++++++++
+           +   +
++ 0+++  + ++ + +
+A  +     A   + +
+  +   +++++++  +
+           D + +
+++++++++++++++++
#end
