#domain
hospital
#levelname
G351
#colors
blue: 0, B, E, C
#initial
+++++++++++++++++
+    E      +  B+
+ ++  +++++ ++  +
+ + C +0  +   + +
+ + ++  ++ ++ +C+
+ +             +
+++++++++++++++++
#goal
+++++++++++++++++
+  E 0 C    +   +
+ ++  +++++ ++  +
+ +   +   +   + +
+ +C++  ++ ++ + +
+ +             +
+++++++++++++++++
#end
