#domain
hospital
#levelname
G352
#colors
blue: 0, 1, 2, 3, A, B, C, D
#initial
+++++++++++++++++++++
+      2            +
+  ++ + +++ ++++ ++++
+   +     +B+D      +
+ + +++++ +++ + +++ +
+   +   +   +     + +
+ ++  B ++  1 ++B++ +
+ 0 A     +   +   +3+
++  ++ ++ +++++ A + +
+               + C +
+++++++++++++++++++++
#goal
+++++++++++++++++++++
+      3      B     +
+  ++ + +++ ++++ ++++
+   +     + +      B+
+ + +++++ +++ + +++ +
+   +   +   +    1+ +
+ ++D   ++    ++ ++B+
+ A       +   +   + +
++ 0++ ++ +++++   + +
+               +A  +
+++++++++++++++++++++
#end
