#domain
hospital
#levelname
G353
#colors
blue: 0, A, B, C
#initial
+++++++++++++
+           +
+ +++ +++++ +
+ + +       +
+ + +B++  + +
+     + + + +
+++ +++ + +++
+  0+   +   +
+++++ +++ + +
+     +     +
+ ++++++  + +
+ +       A +
+ + +++++++ +
+ + +   +   +
+ + + C++ +++
+   +       +
+++++++++++++
#goal
+++++++++++++
+           +
+ +++ +++++ +
+ + +       +
+ + + ++  + +
+     + + + +
+++ +++ + +++
+   +   +  C+
+++++ +++ + +
+     +     +
+ ++++++  + +
+ +         +
+ + +++++++ +
+ +A+   +   +
+ + +  ++ +++
+B  +       +
+++++++++++++
#end
