#domain
hospital
#levelname
G356
#colors
blue: 0, A, B
#initial
+++++++++++++++++
+           +   +
+ B+++++  + +++ +
+   +     +   + +
+ +++ +++++++ 0 +
+   A +   +     +
+++ +++ + + +++ +
+   +   +       +
+++++++++++++++++
#goal
+++++++++++++++++
+           + A +
+  +++++  + +++ +
+   +B    +   + +
+ +++ +++++++   +
+     +   +     +
+++ +++ + + +++ +
+   +   +   0   +
+++++++++++++++++
#end
