#domain
hospital
#levelname
G357
#colors
blue: 0, C
#initial
+++++++++++++
+ +         +
+ + +++ +++ +
+   +C+   + +
+ +++ +++++ +
+   + +   + +
+++ + +   + +
+   +   + + +
+ +++++++ + +
+ +   0 +   +
+ + +++++ + +
+ +     + + +
+ +++++ + + +
+       + + +
+++++++ + + +
+       +   +
+++++++++++++
#goal
+++++++++++++
+ +      C  +
+ + +++ +++ +
+   + + 0 + +
+ +++ +++++ +
+   + +   + +
+++ + +   + +
+   +   + + +
+ +++++++ + +
+ +     +   +
+ + +++++ + +
+ +     + + +
+ +++++ + + +
+       + + +
+++++++ + + +
+       +   +
+++++++++++++
#end
