#domain
hospital
#levelname
G359
#colors
blue: 0, A, E
#initial
+++++++++++++++
+ 0 +         +
+ + + +++ +++++
+ + +         +
+ + +++ +++ + +
+ +     +  E+ +
+  ++++++ +++ +
+ +     + +   +
+ A+  + + ++A++
+     +       +
+++++++++++++++
#goal
+++++++++++++++
+   +         +
+E+ + +++ +++++
+ + +        A+
+ + +++ +++ + +
+ +     + A + +
+  ++++++ +++ +
+ +     + +   +
+  +  + + ++ ++
+0    +       +
+++++++++++++++
#end
