#domain
hospital
#levelname
G36
#colors
blue: 0, 1, 2, 3, A, B
#initial
+++++++++++++
+     +     +
+++ + A +++ +
+   + + +   +
+  ++ +++ + +
+ +       + +
+ +++++++++ +
+     +     +
+B+++ + +++++
+  B+ +     +
+++ + + +++++
+   +    1  +
+ +++++++++++
+ 2 +       +
++  +  +++  +
+   + +30 + +
+ +++++ +   +
+           +
+++++++++++++
#goal
+++++++++++++
+ A   +     +
+++ +   +++ +
+   + + +   +
+  ++ +++ + +
+ +       + +
+ +++++++++ +
+     +     +
+ +++ + +++++
+   + +     +
+++ + + +++++
+   +      2+
+ +++++++++++
+   +B      +
++  +  +++  +
+   + +   + +
+ +++++ +   +
+           +
+++++++++++++
#end
