#domain
hospital
#levelname
G360
#colors
blue: 0, A, B, C, D
#initial
+++++++++++++++++++
+     +C          +
+ +++ + +++++++++ +
+ +   + +         +
+ +++++++ ++++ ++++
+   +     +       +
+ + + +++++ +++++ +
+   +D  +A      + +
+ +++ + + +++++ + +
+   + +   +   + + +
+++ ++++ ++ + +++ +
+ +         +   + +
+ ++++++++ ++++ + +
+   C     +   + + +
+ +++++++ + + + + +
+     B + + +   + +
+++ +   + + +++++0+
+       +         +
+++++++++++++++++++
#goal
+++++++++++++++++++
+     +           +
+ +++ + +++++++++ +
+ +   + +C        +
+ +++++++ ++++ ++++
+   +     +       +
+ + + +++++ +++++ +
+   +   +       + +
+ +++ + + +++++ + +
+   + +   +   + + +
+++ ++++ ++ + +++ +
+ +         +   + +
+ ++++++++0++++ + +
+         +   + + +
+ +++++++ + + + + +
+       +D+ +   + +
+++ +   + + +++++ +
+       +   C     +
+++++++++++++++++++
#end
