#domain
hospital
#levelname
G362
#colors
blue: 0, A
#initial
+++++++++
+       +
+++++++ +
+       +
+ +++++ +
+     + +
+++0+   +
+A    + +
+ +++++ +
+   +   +
+ + + +++
+   + A +
+ + + + +
+ + + + +
+ +++++ +
+       +
+++++++++
#goal
+++++++++
+       +
+++++++ +
+       +
+ +++++ +
+     + +
+++ +   +
+     + +
+ +++++ +
+   +   +
+ + + +++
+   +   +
+ + + + +
+A+ + + +
+ +++++ +
+       +
+++++++++
#end
