#domain
hospital
#levelname
G37
#colors
blue: 0
#initial
+++++++++++++++++++++
+       +         + +
+++ +++ + +++++ + + +
+   +   + +   + +   +
+ +++++++ + +++ +++++
+   +     + +   +   +
+ + + +++++ + +++ +++
+ +   +     +   +   +
+ +++++ +++ +++ +++ +
+     +   + + +   + +
+++++ +++ + + +++ + +
+  0  +   +     +   +
+ +++++ +++++++ +++++
+   +   +   +   +   +
+++ + +++ + + +++++ +
+ + + +   + + +     +
+ + + +  ++++ + +++ +
+     +         +   +
+++++++++++++++++++++
#goal
+++++++++++++++++++++
+       +         + +
+++ +++ + +++++ + + +
+   +   + +   + +   +
+ +++++++ + +++ +++++
+   +     + +   +   +
+ + + +++++ + +++ +++
+ +   +     +   +   +
+ +++++ +++ +++ +++ +
+     +   + + +   + +
+++++ +++ + + +++ + +
+     +   +     +   +
+ +++++ +++++++ +++++
+   +   +   +   +   +
+++ + +++ + + +++++ +
+ + + +   + + +     +
+ + + +  ++++ + +++ +
+     +         +   +
+++++++++++++++++++++
#end
