#domain
hospital
#levelname
G370
#colors
blue: 0
#initial
+++++++++++++++++
+       +       +
+ +++++ +++++ + +
+ +     +   + + +
+++ +++++ + +++ +
+   +     + +   +
+ +++ +++ + + + +
+ + + +   +   + +
+ + + + +++++++++
+ + + +         +
+ + +  ++++++ + +
+ +   +     + + +
+ +0+ + +++ +++ +
+   + + + +     +
+++ +++ + +++++ +
+ +     + +   + +
+ +++++++ + + + +
+   +     + +   +
+ + + + +++ +++++
+ +   +         +
+++++++++++++++++
#goal
+++++++++++++++++
+       +       +
+ +++++ +++++ + +
+ +     +   + + +
+++ +++++ + +++ +
+   +     + +   +
+ +++ +++ + + + +
+ + + +   +   + +
+ + + + +++++++++
+ + + +         +
+ + +  ++++++ + +
+ +   +     + + +
+ + + + +++ +++ +
+   + + + +     +
+++ +++ + +++++ +
+ +     + +   + +
+ +++++++ + + + +
+   +     + +   +
+ + + + +++ +++++
+ +   +         +
+++++++++++++++++
#end
