#domain
hospital
#levelname
G371
#colors
blue: 0, 1, 2, 3, 4, 5, C
#initial
+++++++++++++++++++++
+3+       +   1   + +
+ + +0+++ + + 4 +   +
+       + +   +52   +
+ +++++C++  + ++++  +
+     +           + +
+++++++++++++++++++++
#goal
+++++++++++++++++++++
+ +       +       + +
+ + + +++ + +   +   +
+    2  + +   +     +
+ +++++ ++  + ++++  +
+     +  5        + +
+++++++++++++++++++++
#end
