#domain
hospital
#levelname
G376
#colors
blue: 0, B, D
#initial
+++++++++++
+   + B   +
+ + + +B  +
+ + + + + +
++  + + + +
+   + +   +
+ +++ +++++
+     +   +
+ +++++ + +
+       + +
++ ++++D+ +
+       + +
+0+++  ++ +
+   +     +
+++ +++++++
+         +
+++++++++++
#goal
+++++++++++
+   +0    +
+ + + +   +
+ +B+ + + +
++  + + +B+
+   + +   +
+ +++ +++++
+     +   +
+ +++++ + +
+       + +
++ ++++ + +
+       + +
+ +++  ++ +
+   +     +
+++ +++++++
+         +
+++++++++++
#end
