#domain
hospital
#levelname
G377
#colors
blue: 0, B, C
#initial
+++++++++++++++++++
+       +     +   +
+++++++ +++++ +++ +
+   +       +   + +
+ + + ++ ++ + + + +
+ +   +   + + +   +
+ ++++  + + + +++ +
+B    + +     +   +
+ +++ +++++++   +++
+ + + +   B   +   +
+ + + + C +++++++ +
+   + + +   C   + +
+++ + + +++++ + + +
+   +         +  0+
+++++++++++++++++++
#goal
+++++++++++++++++++
+       +     +   +
+++++++ +++++ +++ +
+   +       +   + +
+ + + ++ ++ + + + +
+ +   +   + + +   +
+ ++++  + + + +++ +
+     + +     +   +
+ +++ +++++++   +++
+ + + +       +   +
+ + + +   +++++++ +
+   + + +     B + +
+++ + + +++++ + + +
+   +       C +   +
+++++++++++++++++++
#end
