#domain
hospital
#levelname
G379
#colors
blue: 0, C
#initial
+++++++++++++++++
+     +     +   +
+ +++++ +++ + + +
+ +   +C0 + + + +
+ + + + + + + + +
+ + +   + +   + +
+ + + +++ +++++ +
+ +   +       + +
+ +++ +  ++++ + +
+ +   +     +   +
+ + +++++++ +++++
+ +     +   +   +
+ +++++ + +++++ +
+   +   + +   + +
+ + +++++ + + + +
+ +         +   +
+++++++++++++++++
#goal
+++++++++++++++++
+     +     +   +
+C+++++ +++ + + +
+ +   +   + + + +
+ + + + + + + + +
+ + +   + +   + +
+ + + +++ +++++ +
+ +   +       + +
+ +++ +  ++++ + +
+ +   +     +   +
+ + +++++++ +++++
+ +     +   +   +
+ +++++ + +++++ +
+   +   + +   + +
+ + +++++ + + + +
+ +         +   +
+++++++++++++++++
#end
