#domain
hospital
#levelname
G380
#colors
blue: 0, B
#initial
+++++++++++++++++++++
+         +         +
+ +++++++ + + +++++ +
+ +     +   +   + + +
+ +++++ +++++++ + + +
+     +   +     +   +
+++++ +++ + +++++ +++
+ +       + +   +   +
+ + ++++++0 + + + +++
+   + +   + +     + +
+ +++ + + + ++++ ++ +
+ +   + +   +   +   +
+ +++ + +++++ + + +++
+ +   +   +   +   + +
+ + +++++ + +++++++ +
+ +     + + +       +
+ +++++ + + + +++++B+
+       +     +     +
+++++++++++++++++++++
#goal
+++++++++++++++++++++
+         +         +
+ +++++++ + + +++++ +
+ +     +   +   + + +
+ +++++ +++++++ + + +
+     +   +     +   +
+++++ +++ + +++++ +++
+ +       + +   +   +
+ + ++++++  + + + +++
+   + +   + +     + +
+ +++ + + + ++++ ++ +
+ +   + +   +   +   +
+ +++ + +++++ + + +++
+ +   +   +   +   + +
+ + +++++ + +++++++ +
+ +     + + +       +
+ +++++ + + + +++++ +
+       +     +     +
+++++++++++++++++++++
#end
