#domain
hospital
#levelname
G382
#colors
blue: 0, 1, 2, 3, 4, A, B, C
#initial
+++++++++++++++++++++
+                   +
+++++++ + ++   +++  +
+       + +   C     +
+ + +++++ +2+++++  ++
+ + +   + +     + + +
+ +++  4+ +++++ + + +
+   + +     +   +   +
+ + + +++++++ +++ + +
+ +     +     + +  C+
+ ++ ++++ ++0++ 3+A +
+ +     +    B    + +
+ + +++++ + + + +++ +
+ +     + + + +   + +
+ +++++ +++ + +++ + +
+     +  1  +   +   +
+++++++++++++++++++++
#goal
+++++++++++++++++++++
+   2               +
+++++++ + ++   +++  +
+       + +         +
+ + +++++ + +++++  ++
+ + +  B+ +     + + +
+ +++   + +++++ + + +
+   + +     +   +   +
+ + + +++++++ +++ + +
+ +     +     + + C +
+ ++ ++++ ++ ++  +  +
+ +     +         + +
+ + +++++ + + + +++ +
+ +     + + + +   + +
+ +++++ +++ + +++ + +
+     +     +   +   +
+++++++++++++++++++++
#end
