#domain
hospital
#levelname
G385
#colors
blue: 0, 1, B, C, D
#initial
+++++++++++++++
+           + +
+ + + +++ + + +
+ + +B  C +   +
+++ ++++0 +++ +
+D+         + +
+1++  + + +++ +
+       +     +
+++++++++++++++
#goal
+++++++++++++++
+           + +
+ + + +++ +1+ +
+ + +     +   +
+++ ++++  +++ +
+ +         + +
+ ++  + + +++ +
+    C  +     +
+++++++++++++++
#end
