#domain
hospital
#levelname
G386
#colors
blue: 0, A, B, D
#initial
+++++++++++++++++++
+   +A    +       +
+++ + + + +++++ + +
+   +   +     +   +
+ + +++  ++++   +D+
+ + + B +   + +   +
+ +++ +++ + + +++ +
+   + +     +B  + +
+ + +A+++++ +++ + +
+ B           + + +
+ +++++ + + +++ + +
+   + +   + +   + +
++  + +++ +++ +++ +
+       + 0       +
+++++++++++++++++++
#goal
+++++++++++++++++++
+   +     +       +
+++ + + + +++++ + +
+   +   +     +   +
+ + +++  ++++   + +
+ + +   +   + +  A+
+ +++ +++ + + +++ +
+   + +     +   + +
+ + + +++++ +++ + +
+        A    + + +
+ +++++ + + +++ + +
+   + +   + +   + +
++  + +++ +++ +++ +
+       +     0   +
+++++++++++++++++++
#end
