#domain
hospital
#levelname
G388
#colors
blue: 0, A, C
#initial
+++++++++
+       +
+++ + + +
+ 0   + +
+ + +++ +
+ + +   +
+ + A + +
+ +C+ + +
+ + +   +
+ + + + +
+   + + +
+     + +
+++++++++
#goal
+++++++++
+       +
+++ + + +
+     + +
+ + +++ +
+ +C+   +
+ +   + +
+ + + + +
+ + +  A+
+ + + + +
+   + + +
+     + +
+++++++++
#end
