#domain
hospital
#levelname
G389
#colors
blue: 0, 1, 2, 3, A, D
#initial
+++++++++
+0D  1  +
++ +  + +
+   2  A+
+ 3     +
+       +
+++++++++
#goal
+++++++++
+  D  1 +
++ +  + +
+2      +
+  0    +
+       +
+++++++++
#end
