#domain
hospital
#levelname
G39
#colors
blue: 0, 1, 2, 3, A
#initial
+++++++++++++++++++
+ +         + +   +
+ + + +1+++ + + + +
+   +       + +   +
+ +++++++++++ + + +
+   3       +   + +
+++ +++++++ + +++ +
+ +       +   +   +
+ +2+++++ + +++ + +
+     +   + +   + +
+ +++++ ++++A +++++
+ +     +     +   +
+ + +++++ + +++ + +
+ +   +   + +   + +
+ +++ +++ + + +++ +
+  0+   + + +   + +
+ + +++ + + +++ + +
+ +     +       + +
+ ++ ++ +++++++++ +
+                 +
+++++++++++++++++++
#goal
+++++++++++++++++++
+ +         + +   +
+ + + + +++ + + + +
+   +       + + A +
+ +++++++++++ + + +
+           +   + +
+++ +++++++ + +++ +
+ +       + 0 +   +
+ + +++++ + +++ + +
+     +   + +   + +
+ +++++ ++++  +++++
+ +     +     +   +
+ + +++++3+ +++ + +
+ +   +   + +   + +
+ +++ +++ + + +++ +
+   +   + + +   + +
+ + +++ + + +++ + +
+ +     +       + +
+ ++ ++ +++++++++ +
+                 +
+++++++++++++++++++
#end
