#domain
hospital
#levelname
G392
#colors
blue: 0
#initial
+++++++++
+       +
+ +++++ +
+   + 0 +
+ + + +++
+ + +   +
+++ +++ +
+   +   +
+ +++ +++
+ +   + +
+ + +++ +
+ +     +
+ +++++ +
+ +   + +
+ + + +++
+       +
+++++++++
#goal
+++++++++
+       +
+ +++++ +
+   +   +
+ + + +++
+ + +   +
+++ +++ +
+   +   +
+ +++ +++
+ +   + +
+ + +++ +
+ +     +
+ +++++ +
+ +   + +
+ + + +++
+       +
+++++++++
#end
