#domain
hospital
#levelname
G394
#colors
blue: 0, A, B, D
#initial
+++++++++
+   0   +
+ ++ ++ +
+     + +
+ +A+++B+
+ +   + +
+++ + + +
+   + + +
+ + + + +
+   + + +
+++ +++ +
+   +   +
+  ++ D +
+ +   + +
+ ++  + +
+     + +
+++++++ +
+     + +
+ + +++ +
+ +     +
+++++++++
#goal
+++++++++
+       +
+ ++ ++ +
+     + +
+ + +++ +
+ +   + +
+++D+ + +
+   + + +
+ + + + +
+   + + +
+++ +++ +
+   +   +
+  ++   +
+ +   + +
+ ++  +A+
+     + +
+++++++B+
+     + +
+ + +++ +
+ +     +
+++++++++
#end
