#domain
hospital
#levelname
G395
#colors
blue: 0, A, B
#initial
+++++++++++++
+     +     +
+ + +++++B+ +
+ +       + +
+ +++++++ + +
+       +   +
+ ++A+  ++  +
+ +   +     +
+ +++ +++++++
+ +         +
+ + +++++++A+
+   +   + + +
+ +++ + + + +
+     +   + +
+0+++++++++ +
+ +       + +
+ + +++++ + +
+       +   +
+++++++++++++
#goal
+++++++++++++
+     +     +
+ + +++++ + +
+ +       + +
+ +++++++ + +
+       +   +
+ ++ +  ++  +
+ +   +     +
+ +++ +++++++
+ +         +
+ + +++++++ +
+   +   + + +
+ +++ + + + +
+     +   + +
+ +++++++++ +
+ +  A    + +
+ + +++++ + +
+ 0     +   +
+++++++++++++
#end
