#domain
hospital
#levelname
G397
#colors
blue: 0, A, C
#initial
+++++++++++
+   +     +
+A  +++   +
+ +       +
+ +++++++ +
+0    +   +
+  ++ +++ +
+   +A  + +
+++++++++++
#goal
+++++++++++
+   +     +
+   +++   +
+ +  C    +
+ +++++++ +
+     +0  +
+  ++A+++ +
+   +   + +
+++++++++++
#end
