#domain
hospital
#levelname
G398
#colors
blue: 0, 1, 2, 3, 4
#initial
+++++++++++
+4+     + +
+ + ++  + +
+ + +   + +
+ +++1  + +
+     +   +
+  +2 +++ +
+3+0  +   +
+ + +++ + +
+ + +   + +
+ +++ +++ +
+         +
+++++++++++
#goal
+++++++++++
+ +     + +
+ + ++  +3+
+ + +   + +
+ +++1  + +
+     +   +
+0 +  +++ +
+ +   +   +
+ + +++ + +
+ + +   + +
+ +++ +++ +
+         +
+++++++++++
#end
