#domain
hospital
#levelname
G403
#colors
blue: 0, A, D
#initial
+++++++++
+A      +
+ +0+++ +
+ + +   +
+ + + +++
+ + +   +
+ + +++ +
+ + +   +
+ A +   +
+ + +   +
+ + +++ +
+ + +   +
+++ + +++
+       +
+ + +++ +
+ + +   +
+ +++ +++
+  D    +
+++++++++
#goal
+++++++++
+       +
+ + +++ +
+ + +   +
+ + + +++
+ + +   +
+ + +++ +
+ + +   +
+   +   +
+ + +   +
+ + +++ +
+ + +   +
+++ + +++
+       +
+ + +++ +
+ + +   +
+ +++ +++
+    0  +
+++++++++
#end
