#domain
hospital
#levelname
G407
#colors
blue: 0, A, B, C, D
#initial
+++++++++++++++
+         +   +
+ D++++++ B++ +
+    C  +     +
+++++ A +++++ +
+  B  +     + +
+ + + + +   + +
+       +   0 +
+++++++++++++++
#goal
+++++++++++++++
+         + C +
+  ++++++  ++ +
+   B   +     +
+++++   +++++ +
+    A+     + +
+ + + + +   + +
+       + D   +
+++++++++++++++
#end
