#domain
hospital
#levelname
G409
#colors
blue: 0, A, B, C, D
#initial
+++++++++++++++++
+         + +   +
+ D++++++   + +++
+ +     + + +   +
+ +++++ + + +++ +
+   +   +   +   +
+++   +++++++ + +
+ + +         + +
+ + +++++++++ + +
+A+   +       + +
+ +++ + ++++++ A+
+   +   +       +
+++ +++++ +++++++
+   + +   +     +
+ + + + +++++++ +
+ +   +       + +
+ +   +++ +++ + +
+   +       +   +
+ + ++++++++0++ +
+ +         B   +
+++++++++++++++++
#goal
+++++++++++++++++
+         + +   +
+  ++++++   + +++
+ +     + + +   +
+ +++++ +B+ +++ +
+   +   +   +   +
+++   +++++++ + +
+ + +    A    + +
+ + +++++++++ + +
+ +   +       +A+
+ +++ + ++++++  +
+   +   +      C+
+++ +++++ +++++++
+   + +   +0    +
+ + + + +++++++ +
+ +   +       + +
+ +   +++ +++ + +
+   +       +   +
+ + ++++++++ ++ +
+ +             +
+++++++++++++++++
#end
