#domain
hospital
#levelname
G411
#colors
blue: 0, D
#initial
+++++++++++
+         +
+ +++ +++++
+   +     +
+ +++++++ +
+ +       +
+ + +++++++
+ +       +
+ +++++++ +
+ +    D  +
+ + +++++ +
+ + +     +
+ + + + +++
+ + + +   +
+++ + + + +
+   +     +
+ ++++++0 +
+   +     +
+++++++++++
#goal
+++++++++++
+         +
+ +++ +++++
+   +     +
+ +++++++ +
+ +       +
+ + +++++++
+ +       +
+ +++++++ +
+ +       +
+ + +++++ +
+ +0+     +
+ + + + +++
+ + + +   +
+++ + + + +
+   +     +
+ ++++++  +
+ D +     +
+++++++++++
#end
