#domain
hospital
#levelname
G412
#colors
blue: 0, A, D
#initial
+++++++++++++
+ +         +
+ A +D+++++ +
+ +       0 +
+ + ++A +   +
+           +
+++++++++++++
#goal
+++++++++++++
+ +    A A  +
+   + +++++ +
+ +         +
+ + ++  +   +
+      0    +
+++++++++++++
#end
