#domain
hospital
#levelname
G414
#colors
blue: 0, 1, 2, 3, A, B, E
#initial
+++++++++++++++++++
+ A  B      +     +
+ +++++++   + + + +
+       + +     + +
+ +++++ +   +++++ +
+     +0  + +   2 +
++E + + +++++ + +++
+   +   +   +A+ 3 +
+ +++ + + + + ++  +
+       1 +     + +
+++++++++++++++++++
#goal
+++++++++++++++++++
+           +   A +
+ +++++++   + + + +
+       +2+     + +
+ +++++ +   +++++ +
+     +E  + +     +
++  + + +++++ + +++
+B  +   +   + +   +
+ +++ + + + + ++  +
+         +  0  + +
+++++++++++++++++++
#end
