#domain
hospital
#levelname
G416
#colors
blue: 0, A, E, C, D
#initial
+++++++++++++
+         + +
+ +E+  ++ + +
+ + + +   C +
+ + + +++++++
+   +   +   +
+++ +++   + +
+ + + + D + +
+ + +  ++++ +
+ + +     0A+
+ + + + +++ +
+   + + + + +
+ +  C++  + +
+   +   +   +
+ +++++ +++++
+           +
+++++++++++++
#goal
+++++++++++++
+         + +
+ + +  ++ + +
+ + + +     +
+ + + +++++++
+   +   +   +
+++ +++   + +
+ + + + AC+ +
+ + +  ++++ +
+ + +  0    +
+ + + + +++C+
+   + + + + +
+ +   ++  + +
+   +   +   +
+ +++++ +++++
+           +
+++++++++++++
#end
