#domain
hospital
#levelname
G418
#colors
blue: 0, A, B
#initial
+++++++++
+     + +
+  ++ + +
+   + + +
+++ B + +
+   + + +
+ ++++  +
+ +  0  +
+ + + +++
+   +   +
+ ++AA+ +
+       +
+++++++++
#goal
+++++++++
+     + +
+  ++ + +
+   + + +
+++   + +
+   + + +
+ ++++  +
+ +B    +
+ +0+ +++
+   +   +
+ ++  + +
+       +
+++++++++
#end
