#domain
hospital
#levelname
G419
#colors
blue: 0, 1, 2, A, D
#initial
+++++++++++++++++++++
+  DA           +   +
+  ++ + + +++ + + + +
+   + +  A  + +   + +
+ +   + ++++ A+++ + +
+   01+ +       +   +
+ A + +A+++ +++ +++ +
+ +       +  2      +
+++++++++++++++++++++
#goal
+++++++++++++++++++++
+D              +   +
+  ++ + + +++ + + + +
+   + +     + +   + +
+ +   + ++++  +++ + +
+     + +       + 0 +
+   + + +++ +++ +++ +
+ +  A A  +         +
+++++++++++++++++++++
#end
