#domain
hospital
#levelname
G423
#colors
blue: 0, 1, 2, 3, 4, B
#initial
+++++++++++++++
+       +     +
+ +++BB +0+++ +
+   + +   +   +
++3 +  ++++   +
+   +     + + +
+ +++++ + + + +
+2        + + +
+++++ + +++ + +
+   + +   + + +
+4  +1 +  + +++
+ + +     +   +
+ +++++++++++ +
+             +
+++++++++++++++
#goal
+++++++++++++++
+       +   2 +
+ +++   + +++ +
+   + +   +   +
++  +  ++++   +
+   +     + + +
+ +++++ + + +4+
+         + + +
+++++ + +++1+ +
+   + +   + + +
+   + 0+  + +++
+ + +     +   +
+ +++++++++++ +
+             +
+++++++++++++++
#end
