#domain
hospital
#levelname
G425
#colors
blue: 0, 1, 2, 3, 4, A, B, D
#initial
+++++++++++
+ +  0+   +
+ +3+   + +
+         +
+A  +++1  +
+4+   +   +
+ ++2D+ + +
+   +   + +
+ A + + + +
+ + + +   +
+ +   +++++
+ + B     +
+++++++++++
#goal
+++++++++++
+ +   +   +
+ +A+0  + +
+      4  +
+   +++   +
+ +   +   +
+ ++  + + +
+   +   + +
+ A +3+ + +
+ + + +   +
+1+B  +++++
+ +       +
+++++++++++
#end
