#domain
hospital
#levelname
G433
#colors
blue: 0, A, B
#initial
+++++++++++++++++
+ +             +
+ + ++ ++ +++ A +
+ + +   + +   + +
+ + +++ 0B+A+ + +
+   + + + + +   +
+ +++ + + + +  ++
+     +   +     +
+++++++++++++++++
#goal
+++++++++++++++++
+ +             +
+ + ++ ++ +++   +
+ + +   + +   + +
+ + +++   + + + +
+   + + + + +   +
+ +++ + + + +  ++
+     +   +     +
+++++++++++++++++
#end
