#domain
hospital
#levelname
G440
#colors
blue: 0, A, B, C, D
#initial
+++++++++++++++++++
+    C      +     +
++++ ++ +++ + + +++
+       +   + +   +
+ +++++++ +++++0+ +
+     +   +       +
+ + + +++ + +++++ +
+   +   + +   +   +
+++++++ + + + + +++
+       +   +     +
+ + +++++++ A +++++
+D+ +   + +   +   +
+ +++ + + + +++ +++
+ +   + +   +   + +
+ + +++ + +++ +++ +
+   +   +   +   + +
+ +++ + ++++ ++ + +
+   + + +       + +
++B + +++ + +++C+ +
+   +     +       +
+++++++++++++++++++
#goal
+++++++++++++++++++
+    C      +     +
++++ ++ +++ + + +++
+       +   + +   +
+ +++++++ +++++ + +
+     +   +       +
+ + + +++ + +++++ +
+   +   + +   +   +
+++++++ + + + + +++
+       +   + B   +
+ + +++++++   +++++
+ + +   + +   +   +
+A+++ + + + +++ +++
+ +   + +   +   + +
+ + +++ + +++ +++ +
+   +   +   +   + +
+ +++ + ++++ ++ + +
+   + + +       + +
++  +D+++ + +++ + +
+   +     +       +
+++++++++++++++++++
#end
