#domain
hospital
#levelname
G447
#colors
blue: 0, 1, 2, 3, A, B
#initial
+++++++++++++++++++++
+     +   +      1  +
+ +++ + + + +3+++ + +
+   +   +   +       +
+++ B ++++++++++++ ++
+   + +     +       +
+ ++ ++ +++ +++++++ +
+       + +     +   +
+ + + +++ +++++ + +++
+   + +     +   + + +
+ +++ + +++ + ++A + +
+ +     +   +   +   +
+ + +++++ + +++ +++ +
+ + +   +   +    0+ +
+ +++ + +++ + +++++ +
+     +     +      2+
+++++++++++++++++++++
#goal
+++++++++++++++++++++
+     +   +         +
+ +++ + + + + +++ + +
+   +   + 3 +       +
+++   ++++++++++++ ++
+   + +     +      2+
+ ++ ++ +++ +++++++ +
+   0   + +     +   +
+ + + +++ +++++ + +++
+   + +     +   + + +
+ +++ + +++ + ++  + +
+ +     +   +   +   +
+ + +++++ + +++ +++ +
+ + +   +   +  B  + +
+ +++ + +++ + +++++ +
+     +     +       +
+++++++++++++++++++++
#end
