#domain
hospital
#levelname
G448
#colors
blue: 0, A, C, D
#initial
+++++++++++++++++
+     +         +
+++A+ +0+++ A D +
+     +   C + + +
+ +A +++  +A    +
+               +
+++++++++++++++++
#goal
+++++++++++++++++
+   A +         +
+++ + + +++     +
+ 0   +     + + +
+A+  +++  +  A  +
+       C       +
+++++++++++++++++
#end
