#domain
hospital
#levelname
G45
#colors
blue: 0, A
#initial
+++++++++++
+   +     +
+ + + +++ +
+ + + + + +
+ +++ + + +
+       + +
+ ++++++A +
+   +   + +
+ ++A   + +
+ +   +   +
+0+ +++++ +
+   +   + +
+ +++   + +
+   + + + +
+ + + + +++
+     +   +
+ +++++++ +
+     +   +
+++++++++++
#goal
+++++++++++
+   +     +
+ + + +++ +
+ + + + + +
+ +++ + + +
+       + +
+ ++++++  +
+   +   +A+
+ ++    + +
+ +   +   +
+ + +++++ +
+   +   + +
+ +++   + +
+   + + + +
+ + + + +++
+     +   +
+ +++++++ +
+     +   +
+++++++++++
#end
