#domain
hospital
#levelname
G455
#colors
blue: 0, D
#initial
+++++++++++++++
+ +   +   + D +
+ + + + + + + +
+ + +   +   + +
+ + +++++++ + +
+ + + +   + + +
+ 0 + + + + + +
+ + +   +   + +
+ + + +++++++ +
+ +   +       +
+ +++ + +++++ +
+       +     +
+++++++++++++++
#goal
+++++++++++++++
+ +   +   +   +
+ + + + + + + +
+ + +   +   + +
+ + +++++++ + +
+ + + +   + + +
+   + + + + + +
+ + +   +   + +
+ + + +++++++ +
+ +   +       +
+ +++ +0+++++ +
+       +     +
+++++++++++++++
#end
