#domain
hospital
#levelname
G462
#colors
blue: 0, A, B, F
#initial
+++++++++++++++++++
+   +             +
+ +++ + + +++++++ +
+ +   + + +     + +
+ + +++ + +++++ + +
+ +   + + +     + +
+ + +++ + + +++++++
+       + + +     +
+ + + +++++ + +++ +
+ A +     + +     +
+ +++++++ + +++ + +
+ F     + +     + +
+ + +++ + +++++++ +
+       +       + +
+++++  ++ ++++0   +
+     + A     + + +
+ +++++ +++++ +++ +
+ +B        +     +
+ +++++++++  ++++++
+      A       A  +
+++++++++++++++++++
#goal
+++++++++++++++++++
+  A+             +
+ +++ + + +++++++ +
+ +   + + +     + +
+ + +++ + +++++ + +
+ +   + + +     + +
+ + +++ + + +++++++
+       + + +  B  +
+ + + +++++ + +++ +
+   +     + +     +
+ +++++++ + +++ + +
+    A  + +     + +
+ + +++ + +++++++ +
+       +       + +
+++++  ++ ++++    +
+     +     0 + + +
+ +++++ +++++ +++ +
+ +         +     +
+ +++++++++  ++++++
+                 +
+++++++++++++++++++
#end
