#domain
hospital
#levelname
G463
#colors
blue: 0, 1, 2, 3, A, D
#initial
+++++++++++++++++++++
+   +     +         +
+ +++ + +++ + ++ ++ +
+   + +     +   +   +
+++ + ++++  ++  + +++
+   + +   + +   +   +
+ +++ + + ++D  ++2+ +
+     + 1     +   + +
+ + +++ +++++ + + + +
+ + + + 3A  +   + + +
+ + + + +0+++ +++ + +
+     +   +     +   +
+++++++++++++++++++++
#goal
+++++++++++++++++++++
+   +     +         +
+ +++ + +++ + ++ ++ +
+   + +     +   +  1+
+++ + ++++  ++  + +++
+   + +   + +   +   +
+A+++ + + ++3  ++ + +
+     +       +   + +
+ + +++ +++++ + + + +
+ + + +     +   + + +
+ + +2+ + +++ +++ + +
+     +   +     +   +
+++++++++++++++++++++
#end
