#domain
hospital
#levelname
G464
#colors
blue: 0
#initial
+++++++++++++++++++
+     +           +
+ + + + +++++++ + +
+ + + +   +     + +
+ + +++++ + +++++ +
+ + +     +   +   +
+ +   +++++++ + +++
+ + + +     + +   +
+ + + +++++ + +++ +
+ + +       + +   +
+ + +++++++ +0+ +++
+ +         + +   +
+++++++++++++++++++
#goal
+++++++++++++++++++
+     +           +
+ + + + +++++++ + +
+ + + +   +     + +
+ + +++++ + +++++ +
+ + +     +   +   +
+ +   +++++++ + +++
+ + + +     + +   +
+ + + +++++ + +++ +
+ + +       + +   +
+ + +++++++ + + +++
+ +         + +   +
+++++++++++++++++++
#end
