#domain
hospital
#levelname
G467
#colors
blue: 0, 1, 2, 3, A, B
#initial
+++++++++++++++++
+     +       + +
+ +++ +++++ + + +
+   +       +   +
+ + + ++ ++0+++++
+ + + +   + +   +
+ + +2+ + +++ + +
+ +     +     + +
+ ++++ +++++++  +
+  A+ +       + +
+++ + + +++++ + +
+     + + +   + +
+ +++ + + + +++ +
+ +     + +     +
+++ +++B+ +++++ +
+A  +     +   + +
+ +++ 1 +++ + + +
+ +   +   + + + +
+ + +++ +++   + +
+   +        3  +
+++++++++++++++++
#goal
+++++++++++++++++
+     +       + +
+ +++ +++++ + + +
+   +       +   +
+0+ + ++ ++B+++++
+ + + +   + +   +
+ + + + + +++ + +
+ +    2+     + +
+ ++++ +++++++  +
+   + +       + +
+++ + + +++++ +A+
+     + + +   + +
+ +++ + + + +++ +
+ +     + +     +
+++ +++ + +++++ +
+   +     +   + +
+ +++   +++ + + +
+ +   +   + + + +
+ + +++ +++   + +
+   +           +
+++++++++++++++++
#end
