#domain
hospital
#levelname
G468
#colors
blue: 0, 1, A, B, E, C
#initial
+++++++++++++++++++++
+   B      C+     + +
+ +++ + +E+ +++ + + +
+     +         + + +
+++ +++ +++A+++++ + +
+   B +   +     + + +
+ +++ +   + +++E+ + +
+ + + + + +   +   + +
+ + + +++ + C + +++ +
+ +       + + + +   +
+ + +++ ++ ++ + + + +
+ +           + +   +
+ ++0 + + +++++ +A+ +
+     + +     + + + +
++++ ++ ++++  + + + +
+   A       +  1    +
+++++++++++++++++++++
#goal
+++++++++++++++++++++
+           +   A + +
+ +++ + + + +++ +B+ +
+     +         + + +
+++ +++ +++ +++++ + +
+     +   +     + + +
+ +++ +   + +++ + + +
+ + + + + +   +   + +
+ +C+ +++ +   + +++ +
+ +0      + + + +   +
+ + +++ ++ ++ + + + +
+ +           + +   +
+ ++  + + +++++ + + +
+     + +     + + + +
++++ ++ ++++  + + + +
+           +       +
+++++++++++++++++++++
#end
