#domain
hospital
#levelname
G470
#colors
blue: 0, 1, 2, A, C, D
#initial
+++++++++++++++++
+ +   D +    0+ +
+ + +++ +   1 + +
+   + 2   + + + +
+ +++++++++ + + +
+ +         + + +
+ +     +++ + + +
+  C    +       +
+++++++++++++++++
#goal
+++++++++++++++++
+ +  C  +     + +
+ + +++ +     + +
+   +     + + + +
+A+++++++++ + + +
+ +         + + +
+ +     +++ + + +
+       +0D  1  +
+++++++++++++++++
#end
