#domain
hospital
#levelname
G471
#colors
blue: 0, A, B
#initial
+++++++++++++++++++
+          0      +
+ + +++ + ++A++++++
+ +   + +     +   +
+ + +++ +++++ + + +
+ + +   +   +   + +
+   + + + B +++ + +
+ +   +   +  A    +
+++++++++++++++++++
#goal
+++++++++++++++++++
+                 +
+ + +++ + ++ ++++++
+ +   + +     +   +
+ + +++ +++++ + +0+
+ + +   +   +   + +
+   + + +   +++ + +
+ +   +   +       +
+++++++++++++++++++
#end
