#domain
hospital
#levelname
G472
#colors
blue: 0, 1, 2
#initial
+++++++++
+     + +
+  ++++ +
+ +     +
+ ++  + +
+  1  + +
+ + 20+ +
+   +   +
+++++++++
#goal
+++++++++
+     + +
+  ++++ +
+ +     +
+ ++0 + +
+     + +
+ +   + +
+   +   +
+++++++++
#end
