#domain
hospital
#levelname
G474
#colors
blue: 0, 1, 2, A
#initial
+++++++++++++++++
+       +       +
+ +++++   +++++1+
+        0+ 2   +
+  ++++++++ ++  +
+             + +
+++++++++++++++++
#goal
+++++++++++++++++
+ A0    +2      +
+ +++++   +++++ +
+         +     +
+  ++++++++ ++  +
+             + +
+++++++++++++++++
#end
