#domain
hospital
#levelname
G475
#colors
blue: 0, 1, E
#initial
+++++++++++
+ +       +
+ +  +  + +
+ + +  0+ +
+ + + ++1 +
+   +  E  +
+++++++++++
#goal
+++++++++++
+ +       +
+ +  +  + +
+ + + E + +
+ + + ++  +
+   +   1 +
+++++++++++
#end
