#domain
hospital
#levelname
G478
#colors
blue: 0, A, B
#initial
+++++++++++++++
+A  +         +
+ +++ +++++++ +
+   + +   B   +
+ +   + +++++ +
+   + +   +   +
+A+++++++ +++++
+ +     +     +
+  ++ + + + + +
+  0 A+       +
+++++++++++++++
#goal
+++++++++++++++
+   +    B    +
+ +++ +++++++ +
+   + +       +
+ +   +0+++++ +
+A  + +   +   +
+ +++++++ +++++
+ +     +     +
+  ++ + + + + +
+     +A      +
+++++++++++++++
#end
