#domain
hospital
#levelname
G479
#colors
blue: 0, 1, 2, 3
#initial
+++++++++
+    1  +
+++ ++  +
+0+ + + +
+2      +
+  3+   +
+++++++++
#goal
+++++++++
+       +
+++1++  +
+ + + + +
+2      +
+3  +   +
+++++++++
#end
