#domain
hospital
#levelname
G48
#colors
blue: 0, E, C
#initial
+++++++++++++++++++++
+              E    +
+ +++++++++++++++ + +
+ +               + +
+ + + +++++++++++++ +
+ + + +       +C    +
+ + +++ +++++ +++  ++
+ + 0   +   +   +   +
+ +++++++ +++++ +++ +
+         +   + + + +
++ ++++ +++ + + + + +
+       +   +   +   +
+ +++++++ +++++++ +++
+ +     + + +     + +
+ + +++   + + +++++ +
+   +   +   +       +
+++++++++++++++++++++
#goal
+++++++++++++++++++++
+                   +
+ +++++++++++++++ + +
+ +               + +
+ + + +++++++++++++ +
+ + + +       +     +
+ + +++ +++++ +++  ++
+ +     +   +E  +   +
+ +++++++ +++++ +++ +
+         +   + + + +
++ ++++ +++ + + + + +
+       +   +   +   +
+ +++++++ +++++++ +++
+ +     + + +     + +
+ + +++   + + +++++ +
+   +   +   +       +
+++++++++++++++++++++
#end
