#domain
hospital
#levelname
G482
#colors
blue: 0, A, B
#initial
+++++++++++++++++
+     +    B  + +
+ ++++  +++ + + +
+     + +   +   +
+++++ + + ++ ++++
+   +   +       +
+ + +++++ + +++ +
+ + +   +   +   +
+ + + + +++++ + +
+ +   +       + +
+ +++++ +++++++ +
+B  +   +B      +
+++ + +++ ++ ++++
+   +   +       +
+ A++ + + +++++ +
+   +   +     + +
+ + 0++++  ++ + +
+ B       + + A +
+A+++++++++ +++++
+               +
+++++++++++++++++
#goal
+++++++++++++++++
+     +       + +
+ ++++  +++ + + +
+     + +   +   +
+++++ + + ++ ++++
+   +   +       +
+ + +++++ + +++ +
+ + +   +   +   +
+ + + + +++++ + +
+ +   +       + +
+ +++++ +++++++ +
+   +   +       +
+++ + +++ ++ ++++
+   +   +       +
+  ++ + + +++++ +
+   +   +     + +
+ +  ++++  ++ +A+
+B        + +   +
+ +++++++++B+++++
+            A  +
+++++++++++++++++
#end
