#domain
hospital
#levelname
G483
#colors
blue: 0, B, C
#initial
+++++++++++++++++++++
+   +         +     +
+ + + +C+ 0 + + + + +
+ +   +   + + + + + +
+ +++ +++++B+ + + + +
+           +     + +
+++++++++++++++++++++
#goal
+++++++++++++++++++++
+   +         +     +
+ + + + +   + + + + +
+ +   + 0 + + + + + +
+ +++ +++++C+ + + + +
+        B  +     + +
+++++++++++++++++++++
#end
