#domain
hospital
#levelname
G488
#colors
blue: 0, A, B
#initial
+++++++++++
+     0   +
+ +++ +++ +
+       + +
++++++  + +
+         +
+ ++++B++ +
+   + +A+ +
+++ +   + +
+     + B +
+++++++++++
#goal
+++++++++++
+         +
+ +++ +++ +
+       + +
++++++  + +
+         +
+B++++A++ +
+   + + + +
+++ + 0 + +
+     +   +
+++++++++++
#end
