#domain
hospital
#levelname
G49
#colors
blue: 0, 1, 2, A, C
#initial
+++++++++++++++++
+A      +   +   +
+  +++A + +  ++ +
+1  +   + +C0   +
+++ + +++ +++++ +
+       + 2 +   +
+ A++++++++ +   +
+     C   +     +
+ +++ +++   +++ +
+       A       +
+++++++++++++++++
#goal
+++++++++++++++++
+       +   +   +
+  +++  + +2 ++ +
+   + A + +A    +
+++ + +++ +++++ +
+       +   +   +
+0 ++++++++ +   +
+         +     +
+ +++ +++ A +++ +
+               +
+++++++++++++++++
#end
