#domain
hospital
#levelname
G490
#colors
blue: 0, A, B, E, D
#initial
+++++++++++++++
+  A        + +
+ +++ +++   + +
+ A       +   +
+ +E+B++++++  +
+ +   +     + +
+D ++  0  +++ +
+ +   + +     +
+++++++++++++++
#goal
+++++++++++++++
+           + +
+ +++ +++   +A+
+         +   +
+ + + ++++++  +
+ +  B+     + +
+  ++ A   +++ +
+ +   + +     +
+++++++++++++++
#end
