#domain
hospital
#levelname
G492
#colors
blue: 0, A
#initial
+++++++++++++++++++
+     A 0     +   +
+ +++++++++++ + +++
+ +     +     +   +
+ + + +++ +++++   +
+ + + +   +   + + +
+ +++ +  ++ + + + +
+   +   +   +   + +
+++++ +++ +++++++A+
+   +   +   +   + +
+ +++++ A++++ + + +
+     +       + + +
+  ++ +++++++++ + +
+   +   +     + + +
+ + +++ + +++ + + +
+     +     +     +
+++++++++++++++++++
#goal
+++++++++++++++++++
+             +   +
+ +++++++++++ + +++
+ +     +     +   +
+ + + +++ +++++   +
+ + + +   +   + + +
+ +++ +  ++ + + + +
+   +   +   +   + +
+++++ +++ +++++++ +
+   +0  +   +   + +
+ +++++  ++++ + + +
+     +       + + +
+  ++ +++++++++ + +
+   +   +    A+ + +
+ + +++ + +++ + + +
+     +     +     +
+++++++++++++++++++
#end
