#domain
hospital
#levelname
G51
#colors
blue: 0, A, B
#initial
+++++++++++++++++++
+ +         + A   +
+ + +++++++   +++ +
+ +   +   + + A   +
+ +++ + + + +++  A+
+  A  +   +     + +
+ +++ +   + + +++ +
+ + + + +0+ + +   +
+ + + + + + + +   +
+BB + + +   +   + +
+ A + + ++++ ++ + +
+   +       A   + +
+++++++++++++++++++
#goal
+++++++++++++++++++
+A+ A       +  A  +
+ + +++++++   +++ +
+ +   +   + +     +
+ +++ + + + +++   +
+     +   +     + +
+ +++ +   + + +++ +
+ + + + + + + +   +
+ + + + + + + +   +
+   + + +   +   + +
+   + + ++++ ++ + +
+   +           + +
+++++++++++++++++++
#end
