#domain
hospital
#levelname
G52
#colors
blue: 0, 1, 2, A, B, C, D
#initial
+++++++++++++++++++
+         +       +
+ + + +++++ +++++ +
+   +         +   +
+ +++++++++D+ +   +
+ +         + + + +
+ + +++++++ ++  +++
+ +    A+ +   +   +
+ +++++0+  ++2++B +
+ +     +   +   + +
+ +C+++++++ +++ + +
+ + +     1 +   + +
+ + +  ++++ + +++ +
+ + + B   + +     +
+ +++++++ + +++++++
+     +   +   +   +
+++++   +++ + + +B+
+   +   + +   +   +
+ + +++++ +  + ++ +
+           D     +
+++++++++++++++++++
#goal
+++++++++++++++++++
+         +       +
+ + + +++++ +++++ +
+   +         +   +
+ +++++++++ + +   +
+ +     0   + + + +
+ + +++++++ ++  +++
+ +     + +   +   +
+ +++++ +  ++ ++  +
+D+     +   +   + +
+ + +++++++D+++ + +
+ + + A     +   + +
+ + +  ++++B+ +++ +
+ + +     + +     +
+ +++++++ +C+++++++
+     +   +   +   +
+++++   +++ + + + +
+   +   + +   +   +
+ + +++++ +  + ++ +
+                 +
+++++++++++++++++++
#end
