#domain
hospital
#levelname
G56
#colors
blue: 0, A, B
#initial
+++++++++++++++++++++
+         +         +
+ + ++++  +++ +++ +++
+ +   + +   + +     +
+ + A + + + + + +++ +
+   + +   + + +   + +
+ + +   B +A  +++ + +
+   + + + +       + +
+++++ + + +++ A + +++
+     + +       + + +
+ A++++0++++++B++ + +
+A                  +
+++++++++++++++++++++
#goal
+++++++++++++++++++++
+         +         +
+ + ++++  +++ +++ +++
+ +   + +  A+ +     +
+ +   + + + + + +++ +
+ A + +   + + +   + +
+ + +     +  0+++ + +
+   + + + +       + +
+++++B+ +A+++   + +++
+     + +       + + +
+  ++++A++++++ ++ + +
+                   +
+++++++++++++++++++++
#end
