#domain
hospital
#levelname
G58
#colors
blue: 0, 1, 2, 3, 4, 5, 6, A, B, C
#initial
+++++++++++++++
+   +        3+
+  A0  C+ + +2+
+   + +       +
+ 4 +   +++ + +
+  5 1    6   +
+++++++++++++++
#goal
+++++++++++++++
+   +  2      +
+       + +B+ +
+   + +4  0   +
+   +  C+++ + +
+       1  3  +
+++++++++++++++
#end
