#domain
hospital
#levelname
G59
#colors
blue: 0, A, B
#initial
+++++++++
+ A     +
+  ++++ +
+     + +
+++ +++ +
+   +   +
+++++ +++
+       +
+ +++ + +
+ +   + +
+ +++++ +
+ B     +
+ + +++++
+ + +   +
+ + +++ +
+ +   + +
+ +0  + +
+   +   +
+ + +++ +
+ +     +
+++++++++
#goal
+++++++++
+       +
+  ++++0+
+     + +
+++ +++ +
+   +   +
+++++ +++
+       +
+ +++ + +
+ +   + +
+ +++++ +
+       +
+B+ +++++
+ + +   +
+ + +++ +
+ +A  + +
+ +   + +
+   +   +
+ + +++ +
+ +     +
+++++++++
#end
