#domain
hospital
#levelname
G60
#colors
blue: 0, A, B
#initial
+++++++++++++++++++
+               A +
+++ +++ +++++   + +
+   +   +     + B +
+ + + +++ + +++ + +
+ +       +   +   +
+ +++++++B+ +++++ +
+ +       B     + +
+ + +++++ +++ + + +
+ + +   +   + 0 + +
+ + + +++++ + + + +
+ + +     + + +   +
+ + +++ + + + +++++
+ +     + + + +   +
+ ++++++  +++ + + +
+         +     + +
+++++++++++++++++++
#goal
+++++++++++++++++++
+           B     +
+++ +++ +++++   + +
+   +   +     +   +
+ + + +++ + +++ + +
+ +       +   +   +
+ +++++++ + +++++ +
+ +             + +
+ + +++++ +++ + + +
+ + +   +   +   + +
+ + + +++++ + + + +
+ + +     + + +   +
+ + +++ + + + +++++
+ +     + + + +   +
+ ++++++  +++ + + +
+         +     +B+
+++++++++++++++++++
#end
