#domain
hospital
#levelname
G61
#colors
blue: 0, B
#initial
+++++++++++++++
+             +
+ +++ +0+++++ +
+ +   +    B  +
+ + +++++++++ +
+ +           +
+++++++++++++++
#goal
+++++++++++++++
+             +
+ +++ + +++++ +
+ +   +      B+
+ + +++++++++ +
+ +           +
+++++++++++++++
#end
