#domain
hospital
#levelname
G64
#colors
blue: 0, 1, 2, A, E, C
#initial
+++++++++++++
+ +       + +
+ ++ ++ + + +
+   2   + E +
+++ + +++++ +
+ +      A+ +
+ +++++ + + +
+       + + +
+ +0+ +++   +
+         + +
+   ++++ ++ +
+A+ +     + +
+1+++ +++ + +
+C      +   +
+++++++++++++
#goal
+++++++++++++
+ +  A    + +
+ ++ ++E+ + +
+      0+   +
+++ + +++++ +
+ +1      + +
+ +++++ + + +
+       + + +
+ + + +++   +
+         + +
+   ++++ ++ +
+ + +     + +
+ +++ +++ + +
+     C +   +
+++++++++++++
#end
