#domain
hospital
#levelname
G65
#colors
blue: 0
#initial
+++++++++++++
+     +   + +
+ +++++ + + +
+ +     +   +
+ + +++++++ +
+ +   +   + +
+ +++ +++ + +
+   +   + + +
+ + + +++ + +
+ + +   +   +
+++ + + + +++
+   + +   + +
+ + +0+++++ +
+ + +   +   +
+ +++++ + + +
+       + + +
+ +++++++ + +
+ +       + +
+ +++++++++ +
+           +
+++++++++++++
#goal
+++++++++++++
+     +   + +
+ +++++ + + +
+ +     +   +
+ + +++++++ +
+ +   +   + +
+ +++ +++ + +
+   +   + + +
+ + + +++ + +
+ + +   +   +
+++ + + + +++
+   + +   + +
+ + + +++++ +
+ + +   +   +
+ +++++ + + +
+       + + +
+ +++++++ + +
+ +       + +
+ +++++++++ +
+           +
+++++++++++++
#end
