#domain
hospital
#levelname
G72
#colors
blue: 0, 1, 2, A, B, C
#initial
+++++++++++++++++++
+         +   +   +
+ +++ 2++ 0 + + + +
+     +   + +   + +
++++A + +   +++ + +
+   C + + + +   + +
+ +++++ + + + ++  +
+   +   + +   +   +
+++ + +++ +++ + + +
+   + + B +   + 1 +
+ +++ +++++ ++ ++ +
+C+ + +   + +     +
+ + + + + + + + + +
+   +   +     +   +
+++++++++++++++++++
#goal
+++++++++++++++++++
+         +   +   +
+ +++  ++   + + + +
+     +   + + 1 + +
++++  + +   +++ + +
+     + + + +   + +
+ +++++ + + + ++  +
+   +   + +   +   +
+++ + +++ +++ + + +
+   + + 02+   +   +
+ +++ +++++ ++ ++ +
+ + + +   + +     +
+ + + + + + + + + +
+ B +   +     +   +
+++++++++++++++++++
#end
