#domain
hospital
#levelname
G76
#colors
blue: 0, A, C
#initial
+++++++++
+       +
+++++++ +
+ A +   +
+ ++  +++
+   C   +
+ + + + +
+ A     +
+ + + + +
+   + +0+
+++ +++ +
+       +
+++++++++
#goal
+++++++++
+       +
+++++++0+
+   +   +
+ ++  +++
+ A     +
+ + + + +
+  A    +
+ + + + +
+   + + +
+++ +++ +
+    C  +
+++++++++
#end
