#domain
hospital
#levelname
G79
#colors
blue: 0, C, D
#initial
+++++++++++
+         +
+ +++++++ +
+   +  C  +
+++ + + +++
+   + +   +
+ + + +++ +
+0  + +   +
+++++ + + +
+     + + +
+ +++++D+++
+ +       +
+  ++ +++ +
+   +   + +
+++ +++++ +
+         +
+++++++++++
#goal
+++++++++++
+ D       +
+ +++++++ +
+   +     +
+++ + + +++
+   + +C  +
+ + + +++ +
+   + +   +
+++++ + + +
+     + + +
+ +++++ +++
+ +       +
+  ++ +++ +
+   +   + +
+++ +++++ +
+         +
+++++++++++
#end
