#domain
hospital
#levelname
G92
#colors
blue: 0, A, B
#initial
+++++++++++
+ + A     +
+ + + +++++
+B        +
+ ++  +++ +
+ 0   +   +
+++++++++++
#goal
+++++++++++
+ +  B    +
+ + +A+++++
+         +
+ ++  +++0+
+     +   +
+++++++++++
#end
