#domain
hospital
#levelname
G96
#colors
blue: 0, A, B
#initial
+++++++++++++++++++
+   + 0     +  A  +
+ + + +++ + + + +++
+ + + +   + +B+   +
+ +++ +  ++ +++++ +
+     +   +       +
+++++ +++ +++ + + +
+   +   +   + +   +
+ +++++ +++ + +++ +
+ +   + + + +   + +
+ + + + + + +++A+ +
+ + +   + + +   + +
+ +++ +++ + + +++ +
+   +     + +     +
+++ +++++++ +++++ +
+ +         + +   +
+ +++++++ + + + +++
+     +   + +  A+ +
+ + + + +++A+ ++  +
+   +       +     +
+++++++++++++++++++
#goal
+++++++++++++++++++
+   +       +     +
+0+A+ +++ + + + +++
+ + + +   + + +   +
+ +++ +  ++ +++++ +
+     +A  +       +
+++++ +++ +++ + + +
+   +   +   + +   +
+ +++++ +++ + +++ +
+ +   + + + +   + +
+ + + + + + +++ + +
+ + +   + + +   + +
+ +++ +++ + + +++ +
+   +     + +     +
+++ +++++++ +++++ +
+ +         + +   +
+ +++++++ + + + +++
+     +   + +   + +
+ + + + +++ + ++  +
+   +       +     +
+++++++++++++++++++
#end
