#domain
hospital
#levelname
N11
#colors
blue: 0,1,2,3,4,5,6,7
#initial
++++++++++
+0       +
+1       +
+2       +
+3       +
+4       +
+5       +
+6       +
+7       +
++++++++++
#goal
++++++++++
+       0+
+       1+
+       2+
+       3+
+       4+
+       5+
+       6+
+       7+
++++++++++
#end
