#domain
hospital
#levelname
N13
#colors
blue: 0,1
#initial
++++++++++
+01      +
+  +++++++
+        +
+++++++  +
+     +  +
+     +  +
+     +  +
+        +
++++++++++
#goal
++++++++++
+        +
+  +++++++
+        +
+++++++  +
+0    +  +
+1    +  +
+     +  +
+        +
++++++++++
#end
