#domain
hospital
#levelname
N15
#colors
blue: 0
#initial
++++++++++
+0       +
+        +
+        +
+ ++++++++
+        +
+        +
++++++++ +
+        +
++++++++++
#goal
++++++++++
+0       +
+        +
+        +
+ ++++++++
+        +
+        +
++++++++ +
+ 0      +
++++++++++
#end
