#domain
hospital
#levelname
N20
#colors
blue: 0,1,A,B
#initial
++++++++++
+        +
+        +
+    +++++
+        +
+   A0   +
+   B1   +
+        +
+        +
+    +++++
+        +
++++++++++
#goal
++++++++++
+        +
+        +
+    +++++
+        +
+        +
+        +
+        +
+ AB     +
+    +++++
+        +
++++++++++
#end
