#domain
hospital
#levelname
N12
#colors
blue: 0,1,2,3,4
#initial
++++++++++
+01234   +
+  +++++++
+        +
+        +
+++++++  +
+        +
+        +
+   01234+
++++++++++
#goal
++++++++++
+        +
+  +++++++
+        +
+        +
+++++++  +
+        +
+        +
+   01234+
++++++++++
#end
