#domain
hospital
#levelname
SAD1
#colors
blue: 0,1,2,3,4,5,6
#initial
++++++++++
+0123456 +
+  +++++++
+        +
+++++++  +
+04   +  +
+15   +  +
+26   +  +
+3       +
++++++++++
#goal
++++++++++
+        +
+  +++++++
+        +
+++++++  +
+04   +  +
+15   +  +
+26   +  +
+3       +
++++++++++
#end
