#domain
hospital
#levelname
SAD1
#colors
blue: 0,1,2,3,4,5,6
#initial
++++++++++
+0123456 +
+        +
+  +++++++
+        +
+++++++  +
+     +  +
+     +  +
+     +  +
+        +
+        +
++++++++++
#goal
++++++++++
+        +
+        +
+  +++++++
+        +
+++++++  +
+05   +  +
+16   +  +
+2    +  +
+3       +
+4       +
++++++++++
#end
