#domain
hospital
#levelname
N14
#colors
blue: 0,A
#initial
++++++++++
+0       +
+ A      +
+  A     +
+   A    +
+    A   +
+     A  +
+      A +
+        +
++++++++++
#goal
++++++++++
+        +
+        +
+        +
+A       +
+A       +
+A       +
+A       +
+A       +
++++++++++
#end
