#domain
hospital
#levelname
SAD1
#colors
blue: 0,A,B
#initial
++++++++++
+0       +
+        +
+        +
+        +
+   A    +
+   B    +
+        +
+        +
++++++++++
#goal
++++++++++
+       A+
+       B+
+        +
+        +
+    A   +
+    B   +
+        +
+        +
++++++++++
#end
