#domain
hospital
#levelname
SAD1
#colors
blue: 0,A
red: 1,B
#initial
++++++++++
+01      +
+        +
+   A    +
+   A    +
+        +
+   B    +
+   B    +
+        +
++++++++++
#goal
++++++++++
+      AA+
+        +
+        +
+        +
+      10+
+        +
+        +
+      BB+
++++++++++
#end
