#domain
hospital
#levelname
AKM
#colors
blue: 0, A
green: 1, B
pink: 2, C
red: 3, D
#initial
++++++++++++++++++++++
+                    +
+                    +
+       ++++++       +
+      0      1      +
+  +++   AABB   +++  +
+  +++   AABB   +++  +
+  +++   C  D   +++  +
+  +++   CCDD   +++  +
+      2       3     +
+       ++++++       +
+                    +
+                    +
++++++++++++++++++++++
#goal
++++++++++++++++++++++
+                    +
+                    +
+  D    ++++++    C  +
+  DD            CC  +
+  +++          +++  +
+  +++          +++  +
+  +++          +++  +
+  +++          +++  +
+  BB            AA  +
+  BB   ++++++   AA  +
+                    +
+                    +
++++++++++++++++++++++
#end
