#domain
hospital
#levelname
AKM
#colors
blue: 0, A
green: 1, B
pink: 2, C
#initial
++++++++++++++++++++++
+                    +
+                    +
+       ++++++       +
+      0      1      +
+  +++   AABB   +++  +
+  +++   AABB   +++  +
+  +++   C      +++  +
+  +++   CC     +++  +
+      2             +
+       ++++++       +
+                    +
+                    +
++++++++++++++++++++++
#goal
++++++++++++++++++++++
+                    +
+                    +
+       ++++++   CC  +
+                 C  +
+  +++          +++  +
+  +++          +++  +
+  +++          +++  +
+  +++          +++  +
+  BB            AA  +
+  BB   ++++++   AA  +
+                    +
+                    +
++++++++++++++++++++++
#end
