#domain
hospital
#levelname
MA_Push
#colors
blue: 0, 1, A, B
#initial
++++++++++++++
+    1+B     +
+     +      +
+     +      +
+     +      +
+     +      +
+     +      +
+     +      +
+     +      +
+A    +0     +
++++++++++++++
#goal
++++++++++++++
+     +      +
+     +      +
+     +      +
+     +      +
+     +      +
+     +      +
+     +      +
+     +      +
+    A+B     +
++++++++++++++
#end
